geoid10,dscore_2013,ascore_2013,pscore_2013,total_score,pop,dist,acre_pp,park_pp
371830501001061,1,2,2,5,1,0.390749,0.022205,0.001144
371830537241045,3,5,5,13,31,1.918185,0,0
371830537241043,3,5,5,13,47,1.94053,0,0
371830528072025,2,4,4,10,4,0.86549,0.010303,0.000189
371830537131003,1,4,5,10,1432,0.503286,0.004246,8.2e-05
371830537241080,3,5,5,13,43,1.548784,0,0
371830536101011,3,5,5,13,804,1.782314,0,0
371830540083009,2,5,5,12,54,1.333104,0,0
371830528064005,3,5,5,13,29,1.628254,0,0
371830526031010,2,4,3,9,18,0.649655,0.009064,0.000828
371830501001064,1,2,1,4,5,0.055152,0.023582,0.002031
371830528061011,2,4,4,10,1,0.87416,0.010303,0.000189
371830505001031,1,4,1,6,20,0.13691,0.006299,0.001513
371830524011048,3,5,5,13,34,2.273481,0,0
371830523023019,3,5,5,13,76,1.66434,0,0
371830540141014,2,4,4,10,1309,1.065299,0.001332,0.00017
371830501001062,1,2,1,4,5,0.104854,0.023061,0.001805
371830506003017,1,4,1,6,28,0.15483,0.006185,0.001655
371830545003000,2,5,5,12,1874,1.383248,0,0
371830523023035,2,4,4,10,1,1.005335,0.00545,0.000141
371830506003018,1,4,1,6,34,0.19994,0.005033,0.001592
371830517003012,2,4,4,10,45,0.806325,0.004062,0.000127
371830541054019,1,4,4,9,5,0.300611,0.011337,0.000103
371830541062054,2,3,4,9,41,0.747698,0.016556,0.000185
371830507003009,1,4,2,7,19,0.309062,0.008484,0.001375
371830501001022,1,4,1,6,2,0.322591,0.006461,0.001721
371830545003030,2,5,5,12,31,1.312517,0,0
371830509002023,1,2,1,4,34,0.232397,0.026505,0.001513
371830537211047,3,5,5,13,1,2.061367,0,0
371830517003023,2,4,4,10,31,0.757903,0.008373,0.000528
371830537071006,2,5,4,11,2,0.965205,0,0.00013
371830540163011,3,5,5,13,4,1.634052,0,0
371830541041006,3,5,5,13,2,1.701459,0,0
371830505001021,1,4,1,6,64,0.20589,0.008227,0.001543
371830509001001,1,2,1,4,267,0.145266,0.02745,0.001944
371830541051029,3,5,5,13,45,2.089135,0,0
371830536101066,1,4,4,9,58,0.503742,0.001964,0.000197
371830518002016,1,4,3,8,26,0.42108,0.007749,0.000585
371830516001014,2,4,3,9,26,0.860804,0.005881,0.000607
371830516001021,2,4,4,10,69,0.726906,0.004688,0.000458
371830501001028,1,2,2,5,4,0.264221,0.022755,0.001317
371830514005010,1,4,3,8,73,0.014167,0.00815,0.000695
371830507003024,1,4,2,7,31,0.040258,0.004497,0.001358
371830506002011,1,4,2,7,15,0.016511,0.008737,0.001361
371830501001032,1,4,1,6,3,0.504857,0.006501,0.001454
371830501001001,1,4,1,6,14,0.077551,0.006475,0.001573
371830528033020,2,5,5,12,4,1.295501,0,0
371830507003034,1,4,2,7,27,0.260956,0.008484,0.001314
371830514004003,2,4,3,9,37,0.695133,0.007505,0.000675
371830523023028,1,4,4,9,3,0.471276,0.00545,0.000141
371830507003025,1,4,2,7,15,0.039928,0.004497,0.001358
371830530081022,1,1,5,7,5,0.008294,0.033889,7.2e-05
371830540133006,3,5,5,13,3,1.751268,0,0
371830508001015,1,2,1,4,4,0.002331,0.026594,0.001591
371830528064011,3,5,5,13,65,1.577404,0,0
371830541042003,1,1,4,6,6,0.191425,0.03317,0.0002
371830516004016,1,4,3,8,26,0.27106,0.005007,0.000651
371830541044010,2,5,5,12,4,1.428732,0,0
371830537093046,4,5,5,14,5,2.947196,0,0
371830501001017,1,4,1,6,47,0.319769,0.006461,0.001721
371830540151014,1,4,4,9,2,0.027066,0.003023,0.000139
371830501001117,1,2,1,4,20,0.145086,0.02745,0.001944
371830527011021,1,4,4,9,51,0.441434,0.002575,0.000102
371830527012004,2,5,5,12,20,1.390735,0,0
371830540082015,2,4,4,10,12,0.929661,0.005321,0.000225
371830545002057,3,5,5,13,3,1.895446,0,0
371830541061045,2,3,4,9,3,1.009687,0.016556,0.000185
371830541051007,3,5,5,13,6,2.15604,0,0
371830541102036,5,5,5,15,20,3.722677,0,0
371830516005004,2,4,3,9,47,0.760802,0.004843,0.000536
371830504002003,1,4,2,7,86,0.006461,0.003765,0.001014
371830536101087,2,4,4,10,41,1.285003,0.001964,0.000197
371830541043023,2,1,4,7,11,1.0997,0.03317,0.0002
371830509002019,1,2,1,4,51,0.134044,0.026469,0.001408
371830509003005,1,2,1,4,24,0.148235,0.026833,0.001782
371830521011017,2,4,4,10,6,0.742405,0.009606,0.000363
371830537241042,3,5,5,13,11,1.857054,0,0
371830514001004,1,4,3,8,15,0.133645,0.005007,0.000651
371830507002013,1,4,2,7,75,0.411795,0.007472,0.001377
371830528072059,5,5,5,15,8,3.337282,0,0
371830503002002,1,2,2,5,4,0.245121,0.024004,0.001387
371830515022025,1,4,4,9,44,0.426629,0.00418,0.000402
371839802001011,4,5,5,14,3,2.845545,0,0
371830503002010,1,3,2,6,13,0.478922,0.021749,0.001013
371830542071051,4,5,5,14,64,3.276568,0,0
371830523021052,1,3,4,8,1,0.439308,0.01927,0.000257
371830536102038,1,4,4,9,2,0.425972,0.001964,0.000197
371830525033001,3,5,5,13,2,1.970788,0,0
371830541063039,1,3,4,8,8,0.507519,0.016556,0.000185
371830517002012,1,4,3,8,68,0.540159,0.00557,0.000665
371830506002010,1,4,1,6,32,0.052902,0.009085,0.001526
371830503001003,1,4,4,9,187,0.158518,0.006466,0.000435
371830537251011,2,5,5,12,494,1.410869,0,0
371830540081001,2,4,4,10,1,0.930993,0.003023,0.000139
371830540081012,1,4,4,9,3,0.482715,0.003023,0.000139
371830527062004,3,5,5,13,339,1.766566,0,0
371830503002006,1,2,1,4,50,0.412962,0.022329,0.001442
371830525051016,1,4,5,10,44,0.091324,0.011085,7.7e-05
371830514005011,1,4,3,8,48,0.00489,0.00815,0.000695
371830512002009,1,4,3,8,27,0.294145,0.0067,0.000533
371830525043001,2,4,4,10,229,1.072874,0.007505,0.00024
371830537252015,2,5,5,12,15,1.420907,0,0
371830540143010,3,5,5,13,34,1.533882,0,0
371830545002011,1,4,1,6,37,0.076059,0.008963,0.00222
371830527071014,2,3,4,9,168,1.155795,0.013635,0.000189
371830540131029,2,5,5,12,140,1.412833,0,0
371830517001017,1,4,4,9,38,0.138712,0.004919,0.000462
371830520021002,1,4,4,9,124,0.554994,0.006846,0.000189
371830540071010,3,5,5,13,4,1.766708,0,0
371830505001024,1,4,2,7,32,0.272242,0.0066,0.001196
371830537241012,3,5,5,13,139,2.015877,0,0
371830528062022,2,4,4,10,19,0.853321,0.006846,0.000189
371830516001018,2,4,3,9,87,0.709978,0.005339,0.000661
371830540041008,1,4,4,9,336,0.232477,0.007237,0.000104
371830504002005,1,4,2,7,6,0.136425,0.004497,0.001319
371830541043043,2,1,4,7,25,1.115472,0.03317,0.0002
371830537142003,2,5,5,12,169,1.328344,0,0
371830527073023,2,4,4,10,107,1.071968,0.011337,0.000103
371830524061004,2,1,4,7,132,0.873326,0.035672,0.00032
371830541051009,3,5,5,13,94,2.221217,0,0
371830507003002,1,4,3,8,20,0.443044,0.002452,0.000941
371830527062020,3,5,5,13,7,2.166253,0,0
371830541054012,1,4,4,9,31,0.33138,0.011337,0.000103
371830526011012,2,4,4,10,96,0.665458,0.004062,0.000127
371830540072007,3,5,5,13,273,1.542018,0,0
371830525071009,2,5,5,12,29,1.307613,0,0
371830524041018,1,1,4,6,684,0.003004,0.035672,0.00032
371830528033038,2,4,4,10,265,1.13078,0.003839,0.000257
371830540043012,2,4,4,10,41,1.094113,0.007237,0.000104
371830537142030,2,3,4,9,168,0.855816,0.01352,0.000195
371830536102018,1,4,4,9,77,0.468988,0.001964,0.000197
371830516004001,1,4,4,9,15,0.576588,0.002704,0.000209
371830515022009,1,4,4,9,24,0.306179,0.00418,0.000402
371830507003022,1,4,2,7,33,0.046842,0.004172,0.001175
371830523022004,1,3,4,8,77,0.469587,0.021712,0.000194
371830506002027,1,4,2,7,11,0.298697,0.007081,0.001165
371830540141080,3,5,5,13,85,1.708069,0,0
371830506001007,1,4,3,8,58,0.306984,0.006516,0.000791
371830536101061,2,4,4,10,22,1.19122,0.001964,0.000197
371830523023031,2,5,5,12,190,1.511084,0,0
371830503002013,1,2,2,5,170,0.501335,0.022194,0.001137
371830537093029,4,5,5,14,14,2.598551,0,0
371830528064051,2,5,5,12,10,1.377732,0,0
371830525032008,2,4,5,11,45,0.924426,0.004523,9.4e-05
371830527061008,2,4,4,10,95,1.219261,0.011337,0.000103
371830525041000,2,4,4,10,90,0.975849,0.007505,0.00024
371830505002007,1,4,3,8,25,0.500361,0.004996,0.000575
371830540011003,1,4,4,9,38,0.326011,0.005553,0.000163
371830540163002,2,5,5,12,47,1.33774,0,0
371830528062039,3,5,5,13,78,2.163884,0,0
371830524093005,1,5,4,10,226,0.27126,0.001195,0.000132
371830509001009,1,2,1,4,212,0.178009,0.025559,0.001523
371830507001023,1,4,1,6,29,0.148972,0.010436,0.001831
371830540141052,2,5,5,12,46,1.46232,0,0
371830528033014,3,5,5,13,735,1.64183,0,0
371830523023001,2,4,4,10,406,0.889482,0.00545,0.000141
371830526011006,2,3,4,9,61,0.817437,0.018318,0.000465
371830536101070,1,4,4,9,40,0.557399,0.001964,0.000197
371830521021045,2,4,4,10,17,0.982578,0.006846,0.000189
371830542071087,3,5,5,13,53,1.648704,0,0
371830523013006,2,1,5,8,20,1.19311,0.033889,7.2e-05
371830541054024,2,4,4,10,436,0.766922,0.011337,0.000103
371830528062043,3,5,5,13,45,2.178923,0,0
371830514005022,1,4,3,8,13,0.165563,0.0067,0.000533
371830528072075,2,4,4,10,85,0.703,0.010303,0.000189
371830528072066,2,4,4,10,15,0.801556,0.010303,0.000189
371830527072001,2,4,4,10,59,1.052239,0.011337,0.000103
371830540122001,1,4,4,9,51,0.63193,0.007237,0.000104
371830540131024,3,5,5,13,122,1.874264,0,0
371830505001009,1,4,2,7,34,0.15071,0.006289,0.001025
371830524063018,4,5,5,14,71,2.518328,0,0
371830541055013,2,5,5,12,74,1.482535,0,0
371830537252001,2,5,5,12,2,1.328071,0,0
371830515022007,1,4,4,9,69,0.123599,0.00418,0.000402
371830541041044,2,4,4,10,232,0.932203,0.003023,0.000139
371830537091013,3,5,5,13,60,1.595089,0,0
371830540071006,2,5,5,12,49,1.301734,0,0
371830545001015,1,3,3,7,45,0.262712,0.020215,0.000854
371830506003026,1,4,1,6,12,0.233448,0.005033,0.001592
371830518001011,1,4,4,9,57,0.354979,0.004919,0.000462
371830536101020,3,5,5,13,32,1.725324,0,0
371830537151005,1,3,4,8,75,0.102223,0.012254,0.000211
371830541102035,5,5,5,15,6,3.778518,0,0
371830504002001,1,4,2,7,63,0.146462,0.004227,0.001137
371830537073001,1,5,4,10,219,0.259843,3.5e-05,0.000258
371830525032015,2,4,5,11,54,1.174257,0.004523,9.4e-05
371830510002010,1,2,1,4,14,0.087893,0.025559,0.001523
371830508002006,1,4,2,7,189,0.39402,0.010117,0.00111
371830515012014,2,4,3,9,33,0.74011,0.00533,0.000602
371830510001005,1,3,3,7,163,0.520214,0.021593,0.000816
371830541062050,1,3,4,8,21,0.585736,0.016556,0.000185
371830540151026,3,5,5,13,131,1.588229,0,0
371830542071062,3,5,5,13,64,1.932289,0,0
371830506003022,1,4,1,6,16,0.209701,0.005871,0.001759
371830537073010,2,4,4,10,23,0.675846,0.005588,0.000292
371830524072010,1,1,4,6,365,0.551666,0.035672,0.00032
371830541131000,5,5,5,15,125,3.454068,0,0
371830540132043,2,5,5,12,126,1.4238,0,0
371830501001063,1,2,1,4,6,0.101376,0.023582,0.002031
371830501001046,1,4,1,6,37,0.162348,0.005637,0.001884
371830524011073,2,4,4,10,6,1.108137,0.00124,0.000144
371830545003018,3,5,5,13,15,1.694199,0,0
371830541053005,3,5,5,13,22,1.786172,0,0
371830537122017,1,4,5,10,10,0.157181,0.004246,8.2e-05
371830527011017,1,4,4,9,68,0.018509,0.002575,0.000102
371830527011006,1,4,4,9,85,0.458613,0.002575,0.000102
371830540151016,2,4,4,10,45,1.077943,0.003023,0.000139
371830537231010,2,4,4,10,66,0.793638,0.010065,0.000331
371830540143012,3,5,5,13,105,1.623505,0,0
371830526011009,2,3,4,9,40,0.814939,0.014256,0.000338
371830540141022,1,4,4,9,130,0.618217,0.001332,0.00017
371830536101021,3,5,5,13,138,1.701946,0,0
371830515011030,2,4,4,10,126,0.659729,0.003074,0.000352
371830540181017,2,4,5,11,2,1.008448,0.002298,8.6e-05
371830541041013,3,5,5,13,123,1.680184,0,0
371830536102115,1,4,4,9,39,0.331923,0.001964,0.000197
371830540132034,2,5,5,12,3,1.376348,0,0
371830540041006,1,4,4,9,189,0.362107,0.007237,0.000104
371830540062006,1,4,4,9,43,0.54482,0.005588,0.000292
371830524061005,2,5,5,12,49,1.493949,0,0
371830514002002,1,4,3,8,42,0.44897,0.006656,0.000573
371830530081041,2,1,5,8,19,1.265816,0.033889,7.2e-05
371830541054001,2,4,4,10,9,1.25825,0.011337,0.000103
371830537071023,1,5,4,10,82,0.522587,0.001169,0.000134
371830541062036,2,4,4,10,2,0.701,0.006846,0.000189
371830501001059,1,2,2,5,1,0.188145,0.02241,0.001287
371830541063005,2,3,4,9,85,0.931893,0.016556,0.000185
371830506003013,1,4,1,6,71,0.11179,0.008919,0.001457
371830540082016,2,4,4,10,258,1.145813,0.003023,0.000139
371830537252028,3,5,5,13,50,1.746205,0,0
371830514001006,1,4,3,8,26,0.109453,0.005007,0.000651
371830504002015,1,4,1,6,37,0.225964,0.004841,0.001516
371830537073002,1,4,4,9,72,0.100336,0.01112,0.000205
371830521012016,1,4,4,9,22,0.32831,0.010931,0.000513
371830514004000,1,4,3,8,59,0.431612,0.007505,0.000675
371830540141008,3,5,5,13,273,1.709565,0,0
371830537152012,2,3,4,9,185,1.062653,0.012254,0.000211
371830540141095,2,4,4,10,85,0.65411,0.001332,0.00017
371830515012010,1,4,3,8,72,0.574775,0.008815,0.000626
371830505002016,1,4,3,8,20,0.435675,0.005561,0.000752
371830514003005,1,4,3,8,24,0.490246,0.005624,0.000621
371830520012009,2,4,2,8,4,0.671625,0.00289,0.00103
371830536101056,2,5,5,12,46,1.466585,0,0
371830541052008,2,5,5,12,29,1.440252,0,0
371830540132026,2,4,4,10,45,1.181107,0.002632,0.000288
371830540122007,1,4,4,9,66,0.237819,0.007237,0.000104
371830528062026,3,5,5,13,39,1.757057,0,0
371830541063027,2,3,4,9,4,0.975039,0.016556,0.000185
371830541063022,1,3,4,8,12,0.251522,0.016556,0.000185
371830540083007,2,4,4,10,36,1.190246,0.003023,0.000139
371830515011012,1,4,3,8,27,0.583752,0.008354,0.000659
371830519003008,1,4,4,9,53,0.131268,0.005013,0.000387
371830537241038,3,5,5,13,70,1.748089,0,0
371830527073015,2,4,4,10,40,1.026057,0.011337,0.000103
371830519001015,1,4,4,9,77,0.40426,0.001756,0.000516
371830530081028,2,5,5,12,569,1.483961,0,0
371830530081037,2,1,5,8,8,1.199402,0.033889,7.2e-05
371830540071013,2,5,4,11,41,1.256477,3.5e-05,0.000128
371830537143008,2,5,5,12,417,1.307803,0,0
371830511012011,2,4,4,10,109,0.779269,0.002044,0.000235
371830527051020,2,4,4,10,179,1.060932,0.004763,0.000215
371830503001023,1,4,3,8,40,0.06161,0.007202,0.0008
371830540171030,2,4,4,10,228,1.057149,0.007237,0.000104
371830538071023,2,4,4,10,92,0.752424,0.010065,0.000201
371830541053020,4,5,5,14,156,2.542851,0,0
371830528061014,2,4,4,10,13,1.051565,0.010303,0.000189
371830515012028,1,4,4,9,89,0.564548,0.005651,0.000487
371830540132011,3,5,5,13,76,1.580953,0,0
371830530081027,2,1,5,8,74,1.059172,0.033889,7.2e-05
371830501001066,1,2,1,4,8,0.002903,0.023582,0.002031
371830514002003,1,4,3,8,54,0.386762,0.006656,0.000573
371830537141006,2,4,5,11,69,1.072774,0.004246,8.2e-05
371830537181019,4,5,5,14,47,2.878955,0,0
371830538082021,3,5,5,13,8,1.559632,0,0
371830510002026,1,2,2,5,55,0.064802,0.025013,0.001274
371830537221005,2,5,5,12,367,1.362591,0,0
371830541043021,2,1,4,7,75,0.907506,0.03317,0.0002
371830542071041,3,5,5,13,56,2.249032,0,0
371830527043014,1,4,4,9,125,0.322738,0.004763,0.000215
371830525042013,2,4,4,10,24,0.754681,0.007505,0.00024
371830528072023,2,4,4,10,32,0.880251,0.010303,0.000189
371830527071001,2,4,4,10,233,1.236812,0.011337,0.000103
371830538082020,3,5,5,13,41,1.605698,0,0
371830537181016,5,5,5,15,1,4.114191,0,0
371830537211025,3,5,5,13,27,2.231046,0,0
371830501001031,1,2,1,4,182,0.534903,0.022685,0.001452
371830537211039,2,4,4,10,17,1.009291,0.010065,0.000201
371830526011029,1,4,4,9,34,0.365663,0.004062,0.000127
371830506003004,1,4,1,6,34,0.06765,0.009823,0.001905
371830510001002,1,3,3,7,18,0.378388,0.021651,0.000886
371830524093008,2,5,5,12,907,0.768909,1.9e-05,5.2e-05
371830508001004,1,4,2,7,30,0.227807,0.007541,0.001158
371830540131034,2,1,4,7,52,1.224685,0.076914,0.000488
371830537141011,2,4,5,11,41,0.667375,0.004246,8.2e-05
371830540041002,2,4,4,10,108,0.662068,0.009896,0.000173
371830525051013,2,3,4,9,173,1.158896,0.015238,0.00041
371830541054008,2,4,4,10,215,0.728824,0.011337,0.000103
371830540071003,2,5,4,11,62,1.04371,3.5e-05,0.000128
371830506003008,1,4,1,6,49,0.17408,0.00561,0.001793
371830541052030,3,5,5,13,36,1.752959,0,0
371830521011006,2,4,4,10,6,0.709059,0.009606,0.000363
371830540151045,1,4,4,9,5,0.567621,0.003023,0.000139
371830537241070,2,5,5,12,106,1.351922,0,0
371830540043015,2,5,5,12,336,1.342795,0,0
371830515012019,2,4,3,9,53,0.772772,0.00533,0.000602
371830545001024,1,3,3,7,40,0.302539,0.019889,0.000608
371830525071006,2,5,5,12,43,1.294948,0,0
371830528064018,2,4,4,10,190,1.091266,0.010303,0.000189
371830536102017,1,4,4,9,52,0.359808,0.001964,0.000197
371830541051015,3,5,5,13,63,2.057779,0,0
371830542091076,3,5,5,13,23,2.344929,0,0
371830540012001,2,4,5,11,47,1.286608,0.002659,6.9e-05
371830518001017,1,4,4,9,67,0.043189,0.006237,0.000524
371830537093043,4,5,5,14,133,2.970916,0,0
371830523021000,1,3,4,8,25,0.614443,0.019121,0.000148
371830538082005,3,5,5,13,39,2.005754,0,0
371830536101081,3,5,5,13,75,2.116102,0,0
371830545001032,1,3,3,7,40,0.245756,0.019889,0.000669
371830518002017,1,4,4,9,72,0.304793,0.006237,0.000524
371830537232006,1,5,4,10,90,0.573421,0,0.00013
371830525061004,1,3,3,7,64,0.623802,0.013421,0.000543
371830509003011,1,2,1,4,47,0.065192,0.026737,0.001546
371830537121017,1,4,5,10,7,0.083295,0.004246,8.2e-05
371830537111023,3,5,5,13,144,1.594195,0,0
371830528063016,3,5,5,13,154,1.914002,0,0
371830541103015,5,5,5,15,55,3.756349,0,0
371830530081049,3,5,5,13,39,1.646216,0,0
371830525032017,2,4,5,11,43,0.676908,0.004523,9.4e-05
371830526012007,1,4,4,9,183,0.487887,0.004062,0.000127
371830521014021,1,3,3,7,19,0.43317,0.013541,0.00076
371830540131012,2,5,5,12,3,1.437142,0,0
371830515011027,2,4,4,10,89,0.9802,0.004112,0.000423
371830541043042,2,1,4,7,29,1.024528,0.03317,0.0002
371830542091077,5,5,5,15,7,3.468867,0,0
371830540112000,2,2,3,7,123,1.098338,0.025679,0.000856
371830541044003,2,5,5,12,84,1.290057,0,0
371830505001001,1,4,3,8,19,0.34605,0.005984,0.00081
371830521021003,2,4,4,10,254,0.715106,0.006846,0.000189
371830505001016,1,4,2,7,36,0.229929,0.006579,0.001119
371830530081045,2,5,5,12,98,1.387602,0,0
371830540171007,3,5,5,13,297,1.930552,0,0
371830540163017,2,5,5,12,128,1.424731,0,0
371830541051019,3,5,5,13,13,1.827211,0,0
371830525061005,1,4,4,9,49,0.308449,0.010986,0.000424
371830512003003,1,4,3,8,16,0.001601,0.00815,0.000695
371830536101037,2,5,5,12,5,1.467728,0,0
371830537252031,3,5,5,13,239,1.750901,0,0
371830537251023,2,5,5,12,36,1.478099,0,0
371830526022008,1,4,4,9,13,0.405167,0.002575,0.000102
371830525052002,2,4,5,11,29,1.192897,0.011085,7.7e-05
371830530081004,3,5,5,13,77,2.092129,0,0
371830527072002,2,3,4,9,21,1.024013,0.013635,0.000189
371830506003020,1,4,1,6,103,0.269814,0.005033,0.001592
371830541063009,2,3,4,9,88,0.761312,0.016556,0.000185
371830516004004,1,4,4,9,29,0.388279,0.00418,0.000402
371830525031020,2,4,5,11,57,1.093262,0.004523,9.4e-05
371830525033020,2,5,5,12,138,1.424962,0,0
371830540082009,2,4,4,10,34,0.704566,0.003023,0.000139
371830528072062,2,4,4,10,3,1.130125,0.010303,0.000189
371830519001019,1,4,3,8,65,0.318451,0.005104,0.000535
371830542081089,3,5,5,13,32,2.171807,0,0
371830515012011,2,4,3,9,27,0.661374,0.004292,0.000532
371830519001020,1,4,3,8,35,0.001796,0.005806,0.00079
371830501001087,1,2,2,5,6,0.154199,0.021861,0.001244
371830525071005,2,5,5,12,499,1.321711,0,0
371830541044017,2,4,4,10,1,0.920605,0.011337,0.000103
371830537141014,2,4,5,11,60,0.921033,0.004246,8.2e-05
371830537072005,2,5,4,11,267,0.910441,0.001169,0.000264
371830501001101,1,2,1,4,3,0.053878,0.023005,0.00183
371830536102107,1,4,4,9,157,0.381729,0.001964,0.000197
371830541042031,2,1,4,7,124,0.706039,0.03317,0.0002
371830541131003,2,5,5,12,60,1.444432,0,0
371830540134016,2,5,5,12,86,1.385588,0,0
371830525071013,2,3,3,8,64,1.041341,0.013421,0.000543
371830537093026,3,5,5,13,9,1.91178,0,0
371830528064031,3,5,5,13,565,2.11165,0,0
371830541051006,3,5,5,13,68,2.129486,0,0
371830523021022,3,5,5,13,30,1.629373,0,0
371830510001022,1,3,3,7,44,0.380774,0.021651,0.000886
371830540111002,2,5,5,12,27,1.509904,0,0
371830540083001,2,5,5,12,798,1.402781,0,0
371830541042002,1,1,4,6,4,0.053037,0.03317,0.0002
371830540151034,1,4,4,9,15,0.459691,0.003023,0.000139
371830537093022,3,5,5,13,11,2.139537,0,0
371830520022009,1,4,3,8,25,0.444204,0.001467,0.000655
371830537181021,5,5,5,15,67,3.561987,0,0
371830514002004,1,4,3,8,70,0.154821,0.006832,0.000633
370630019002072,5,5,5,15,68,4.786464,0,0
371830516005000,2,4,4,10,46,0.685864,0.004688,0.000458
371830501001072,1,2,1,4,289,0.028112,0.026881,0.001562
371830536101002,3,5,5,13,295,1.823834,0,0
371830527043025,1,4,4,9,118,0.246757,0.004763,0.000215
371830521014007,1,3,3,7,31,0.56861,0.014794,0.000604
371830520012000,2,5,5,12,133,1.43747,0,0
371830540182010,2,4,4,10,38,1.134129,0.007237,0.000104
371830501001037,1,2,2,5,27,0.264291,0.022755,0.001317
371830538082018,3,5,5,13,50,1.996075,0,0
371830516005005,1,4,4,9,32,0.568921,0.004688,0.000458
371830541052005,3,5,5,13,157,1.756188,0,0
371830537181022,5,5,5,15,47,3.714485,0,0
371830537121004,1,4,5,10,2,0.191976,0.004246,8.2e-05
371830540182012,2,4,4,10,71,1.163334,0.007237,0.000104
371830540141006,3,5,5,13,9,1.787531,0,0
371830525062004,2,4,4,10,427,1.096388,0.010986,0.000424
371830503002004,1,2,2,5,207,0.300731,0.024122,0.001203
371830524062003,4,5,5,14,372,2.547005,0,0
371830542091073,4,5,5,14,4,3.058273,0,0
371830528063001,2,3,4,9,69,0.936274,0.016556,0.000185
371830540162031,2,5,5,12,123,1.450216,0,0
371830509003009,1,2,1,4,38,0.080784,0.026833,0.001782
371830525052007,2,4,4,10,85,1.267374,0.004153,0.000334
371830518002002,1,4,4,9,120,0.347609,0.004919,0.000462
371830527062021,3,5,5,13,19,2.429758,0,0
371830526011020,1,4,4,9,163,0.61577,0.004062,0.000127
371830542071043,3,5,5,13,37,2.14439,0,0
371830540134025,3,5,5,13,74,1.940315,0,0
371830524062032,3,5,5,13,48,1.553522,0,0
371830541043047,2,4,4,10,2,1.030695,0.003023,0.000139
371830537241087,2,5,5,12,152,1.342532,0,0
371830521014030,1,3,3,7,69,0.33129,0.014794,0.000604
371830527043009,1,4,4,9,36,0.298079,0.004763,0.000215
371830519002015,2,4,4,10,331,0.673589,0.005034,0.000464
371830509001018,1,2,1,4,60,0.091999,0.02745,0.001944
371830540143015,2,5,5,12,22,1.501076,0,0
371830525042004,2,4,4,10,251,0.853168,0.007505,0.00024
371830540143034,2,5,5,12,57,1.476719,0,0
371830527013001,2,4,4,10,123,1.027189,0.002575,0.000102
371830537132006,1,4,5,10,72,0.36183,0.004246,8.2e-05
371830526011023,1,4,4,9,17,0.371308,0.004062,0.000127
371830501001086,1,2,2,5,7,0.063543,0.021861,0.001244
371830527043010,1,4,5,10,28,0.502174,0.002298,8.6e-05
371830520022006,1,4,3,8,202,0.412898,0.001467,0.000655
371830528072016,1,4,4,9,175,0.598056,0.010303,0.000189
371830540123001,1,4,4,9,71,0.45999,0.007237,0.000104
371830540182004,3,5,5,13,21,1.636277,0,0
371830504001034,1,4,3,8,42,0.214999,0.005741,0.000796
371830525051000,2,4,5,11,913,1.167308,0.011085,7.7e-05
371830524072006,1,4,4,9,404,0.613536,0.001783,0.000248
371830525051012,1,4,5,10,33,0.324132,0.011085,7.7e-05
371830540161005,2,1,4,7,343,0.931182,0.059635,0.000247
371830530081040,2,5,5,12,2,1.291329,0,0
371830537121014,1,4,5,10,3,0.384875,0.004246,8.2e-05
371830520012018,2,4,2,8,10,0.741674,0.002927,0.001096
371830537171030,4,5,5,14,114,2.450388,0,0
371830516003010,1,4,4,9,88,0.577005,0.004512,0.000416
371830542091071,4,5,5,14,7,3.1936,0,0
371830540131037,2,1,4,7,157,1.261445,0.076914,0.000488
371830519001002,2,5,5,12,40,1.304052,0,0
371830506002034,1,4,1,6,29,0.118289,0.005849,0.001687
371830537071021,2,5,4,11,16,1.130684,0,0.00013
371830540171019,2,5,5,12,111,1.30429,0,0
371830517001013,1,4,4,9,49,0.084263,0.004919,0.000462
371830525051022,1,4,4,9,58,0.285704,0.007136,0.00048
371830541103009,5,5,5,15,105,3.583069,0,0
371830506002021,1,4,2,7,42,0.178939,0.006781,0.00098
371830507003029,1,4,1,6,18,0.151739,0.008502,0.001494
371830541053016,4,5,5,14,97,2.631621,0,0
371830541055009,2,5,5,12,13,1.34935,0,0
371830545001028,1,4,1,6,2,0.354292,0.007827,0.001693
371830528033022,3,5,5,13,8,1.66175,0,0
371830521013002,2,4,4,10,72,1.165689,0.010476,0.000232
371830525071007,3,5,5,13,27,1.554095,0,0
371830505002017,1,4,3,8,62,0.563494,0.005523,0.000687
371830525061001,2,3,3,8,74,0.719652,0.013421,0.000543
371830516003002,2,4,4,10,91,0.854043,0.003754,0.000332
371830540181029,2,4,5,11,154,0.658511,0.002298,8.6e-05
371830525032010,2,4,5,11,209,0.842359,0.004523,9.4e-05
371830525042009,2,4,4,10,194,0.859987,0.007505,0.00024
371830527043011,1,4,5,10,59,0.37648,0.002298,8.6e-05
371830537181011,5,5,5,15,60,3.541436,0,0
371830537251019,2,3,4,9,78,0.916605,0.012746,0.000229
371830542091068,4,5,5,14,70,3.13317,0,0
371830523022003,2,4,4,10,60,0.907756,0.00545,0.000141
371830519003007,1,4,4,9,61,0.228195,0.005013,0.000387
371830520012024,2,4,2,8,48,0.807659,0.00289,0.00103
371830537223009,2,4,4,10,22,0.659556,0.010065,0.000331
371830503001004,1,4,3,8,54,0.196367,0.006861,0.000633
371830524062023,3,5,5,13,1,1.794813,0,0
371830521021021,1,4,4,9,55,0.502765,0.001325,0.00015
371830524011070,2,4,4,10,32,1.126222,0.00124,0.000144
371830542081118,2,5,5,12,26,1.4903,0,0
371830537241015,3,5,5,13,109,2.290725,0,0
371830542102030,5,5,5,15,207,3.665053,0,0
371830540043003,2,4,4,10,42,0.658266,0.007237,0.000104
371830518002027,1,4,4,9,38,0.220695,0.004688,0.000458
371830542091052,5,5,5,15,108,3.628949,0,0
371830528064048,3,5,5,13,53,1.881624,0,0
371830519001033,1,4,3,8,18,0.236668,0.005806,0.00079
371830509002008,1,2,1,4,67,0.084682,0.022295,0.001423
371830516005016,2,4,3,9,33,0.651271,0.005097,0.00065
371830520011012,2,4,4,10,7,1.078288,0.006846,0.000189
371830528061001,2,4,4,10,18,1.219635,0.010303,0.000189
371830524071018,2,4,4,10,324,0.771075,0.001783,0.000248
371830537111030,2,4,5,11,180,0.706154,0.004246,8.2e-05
371830537163008,1,3,4,8,62,0.256892,0.016915,0.000407
371830542081122,2,4,4,10,254,1.209289,0.002632,0.000288
371830517001004,2,4,3,9,49,0.753333,0.009069,0.000763
371830519001032,1,4,4,9,68,0.426985,0.005022,0.000526
371830506001001,1,4,3,8,512,0.586603,0.006033,0.000665
371830525043027,2,4,5,11,25,0.700088,0.004523,9.4e-05
371830537093008,3,5,5,13,37,2.274509,0,0
371830530081059,2,1,5,8,26,0.840547,0.033889,7.2e-05
371830519001007,2,4,4,10,86,0.773119,0.001473,0.000378
371830507003013,1,4,2,7,6,0.095462,0.004159,0.001116
371830540132046,3,5,5,13,212,1.682848,0,0
371830505001000,1,4,2,7,36,0.230821,0.006289,0.001025
371830523023021,2,5,5,12,168,1.302651,0,0
371830540141048,2,4,4,10,43,0.69413,0.001332,0.00017
371830537113007,1,3,4,8,323,0.60224,0.012746,0.000229
371830519002001,1,4,4,9,53,0.539372,0.005013,0.000387
371830525071004,2,4,4,10,71,1.214172,0.010986,0.000424
371830537162002,1,3,4,8,38,0.019876,0.014256,0.000338
371830505001027,1,4,2,7,34,0.157922,0.006265,0.001043
371830518002020,1,4,4,9,60,0.368114,0.006237,0.000524
371830528064009,3,5,5,13,578,1.811697,0,0
371830525032020,2,4,5,11,112,0.732772,0.004523,9.4e-05
371830527072005,2,4,4,10,47,1.074589,0.004763,0.000215
371830521011019,1,4,4,9,95,0.419949,0.002993,0.000222
371830542091062,4,5,5,14,258,3.18285,0,0
371830540061006,3,5,5,13,25,1.550248,0,0
371830540182007,2,5,5,12,2,1.468,0,0
371830524062021,3,5,5,13,21,2.316997,0,0
371830540111007,2,5,5,12,84,1.494077,0,0
371830541103021,5,5,5,15,50,4.318704,0,0
371830540072015,2,5,4,11,166,1.225689,3.5e-05,0.000258
371830516004003,1,4,3,8,39,0.371099,0.004929,0.000597
371830527012030,3,5,5,13,27,1.547355,0,0
371830521011003,1,4,4,9,33,0.433123,0.009606,0.000363
371830545001009,1,3,2,6,28,0.078326,0.021678,0.001069
371830537143007,2,4,5,11,157,1.213974,0.004246,8.2e-05
371830540061009,2,5,5,12,112,1.340903,0,0
371830542071089,2,5,5,12,127,1.334904,0,0
371830516002002,2,4,4,10,88,1.107313,0.00255,0.000131
371830537222006,2,5,4,11,36,0.644204,0,0.00013
371830512002021,1,3,3,7,5,0.556226,0.021635,0.000878
371830537142027,2,3,4,9,56,0.81225,0.01352,0.000195
371830537122002,2,4,4,10,88,0.906395,0.010065,0.000201
371830508001014,1,4,2,7,7,0.067258,0.009836,0.001346
371830542102045,5,5,5,15,13,3.937119,0,0
371830526011024,1,4,4,9,15,0.509815,0.004062,0.000127
371830524041011,1,1,4,6,24,0.35968,0.036848,0.0004
371830537131005,2,4,5,11,44,1.165522,0.004246,8.2e-05
371830505001019,1,4,2,7,39,0.2496,0.006604,0.001238
371830507001008,1,4,1,6,43,0.224136,0.008752,0.001736
371830540171016,2,5,5,12,9,1.409985,0,0
371830540171034,2,4,4,10,28,0.765721,0.007237,0.000104
371830537252010,2,4,4,10,141,1.170572,0.0085,0.000147
371830527061013,2,5,5,12,86,1.301409,0,0
371830524082007,1,5,4,10,49,0.166878,0.001195,0.000132
371830545001034,1,3,3,7,123,0.570794,0.019889,0.000608
371830537122005,2,4,4,10,10,1.215954,0.010065,0.000201
371830527012032,3,5,5,13,55,1.555466,0,0
371830521012005,1,4,4,9,139,0.191116,0.010931,0.000513
371830537112025,1,3,4,8,49,0.593579,0.012746,0.000229
371830540121014,2,4,4,10,23,1.141304,0.007237,0.000104
371830540134041,3,5,5,13,19,1.828526,0,0
371830537093032,5,5,5,15,83,3.669855,0,0
371830541102053,4,5,5,14,112,3.315437,0,0
371830508001018,1,4,2,7,53,0.176166,0.00849,0.001388
371830527071005,2,4,4,10,47,1.008354,0.011337,0.000103
371830521021004,2,4,4,10,173,0.972028,0.006846,0.000189
371830525031004,3,5,5,13,20,1.744328,0,0
371830541063024,2,3,4,9,94,0.792687,0.016556,0.000185
371830540072006,3,5,5,13,22,1.668147,0,0
371830516003007,1,4,3,8,79,0.438442,0.006311,0.000734
371830541103006,5,5,5,15,55,4.860015,0,0
371830524072019,1,1,4,6,36,0.128399,0.036848,0.0004
371830537232000,2,5,4,11,8,1.05507,0,0.00013
371830541131020,5,5,5,15,33,4.672974,0,0
371830504002010,1,4,1,6,6,0.248481,0.00478,0.001457
371830537113020,1,3,4,8,1,0.282817,0.012746,0.000229
371830524042000,2,1,4,7,216,0.753204,0.035084,0.000204
371830524062014,3,5,5,13,115,1.617462,0,0
371830524093009,2,1,4,7,133,0.653005,0.035084,0.000204
371830524072001,2,4,4,10,74,0.715976,0.00124,0.000144
371830538082017,3,5,5,13,51,1.851679,0,0
371830540112008,2,2,3,7,117,1.281759,0.025679,0.000856
371830527063011,3,5,5,13,7,2.223252,0,0
371830537252048,3,5,5,13,53,1.589627,0,0
371830509003003,1,2,1,4,84,0.009581,0.026737,0.001546
371830505001013,1,4,2,7,42,0.155162,0.006289,0.001025
371830542091069,4,5,5,14,46,3.179385,0,0
371830516002003,2,5,5,12,52,0.855736,0.001038,7e-05
371830540181021,2,4,4,10,275,1.150342,0.007237,0.000104
371830537221009,2,5,5,12,41,1.300103,0,0
371830537251017,2,3,4,9,79,1.158345,0.012746,0.000229
371830537142019,1,3,3,7,11,0.326424,0.013421,0.000543
371830537113012,2,3,4,9,98,0.946002,0.012746,0.000229
371830541102003,4,5,5,14,43,2.875639,0,0
371830527061025,2,4,4,10,36,1.218428,0.011337,0.000103
371830541102018,5,5,5,15,21,3.81596,0,0
371830541053027,4,5,5,14,149,2.539201,0,0
371830541051032,3,5,5,13,15,1.894284,0,0
371830517001002,1,4,3,8,70,0.299787,0.009511,0.000789
371830519001027,2,4,4,10,26,1.21135,0.001452,0.000301
371830540181006,2,4,4,10,4,0.66444,0.007237,0.000104
371830537111009,2,4,5,11,147,0.959599,0.004246,8.2e-05
371830537152009,2,3,4,9,75,0.954422,0.012254,0.000211
371830540181008,2,5,5,12,17,1.507064,0,0
371830507003031,1,4,1,6,15,0.241771,0.00852,0.001611
371830540131014,2,5,5,12,14,1.340972,0,0
371830501001110,1,2,1,4,156,0.006971,0.023255,0.001744
371830501001044,1,4,1,6,7,0.230563,0.005192,0.001822
371830524041008,1,1,4,6,40,0.203469,0.036848,0.0004
371830525051004,2,3,4,9,133,1.137787,0.015238,0.00041
371830523021033,1,3,5,9,32,0.506589,0.019102,9.6e-05
371830525072022,3,5,5,13,45,1.769918,0,0
371830540132016,2,4,4,10,114,0.993079,0.002632,0.000288
371830527052001,1,4,4,9,90,0.491808,0.004763,0.000215
371830505001018,1,4,2,7,36,0.276418,0.006579,0.001119
371830528072003,3,5,5,13,3,1.865581,0,0
371830540171031,2,4,4,10,77,1.115524,0.007237,0.000104
371830512002019,1,3,3,7,52,0.37054,0.021718,0.000727
371830536102108,1,4,4,9,193,0.196997,0.001964,0.000197
371830518002029,1,4,4,9,34,0.047359,0.006237,0.000524
371830523021007,2,3,4,9,54,0.772563,0.019121,0.000148
371830530082002,2,4,4,10,7,1.280091,0.00545,0.000141
371830540133003,3,5,5,13,69,1.581745,0,0
371830540171024,2,4,4,10,19,1.182913,0.007237,0.000104
371830506003007,1,4,1,6,42,0.255118,0.00561,0.001793
371830511012013,1,4,4,9,25,0.535979,0.002044,0.000235
371830540121000,2,4,4,10,136,1.193891,0.007237,0.000104
371830524011026,4,5,5,14,678,2.637448,0,0
371830537151002,1,3,4,8,71,0.317855,0.012254,0.000211
371830524041016,1,1,4,6,53,0.081329,0.036848,0.0004
371830501001070,1,2,1,4,3,0.063118,0.022656,0.001628
371830537093051,4,5,5,14,113,2.552723,0,0
371830527072010,2,3,4,9,5,0.968794,0.013802,0.000231
371830541062045,1,3,4,8,137,0.470658,0.016556,0.000185
371830537112000,2,5,5,12,20,1.510389,0,0
371830528033026,2,5,5,12,34,1.301318,0,0
371830505002015,1,4,3,8,62,0.34449,0.005567,0.000811
371830540083003,2,4,4,10,88,1.273616,0.003023,0.000139
371830507001018,1,2,1,4,35,0.049279,0.026698,0.001884
371830540141090,3,5,5,13,65,1.912852,0,0
371830525031007,2,5,5,12,5,1.531372,0,0
371830537073004,1,3,3,7,176,0.619455,0.01546,0.0006
371830545003008,2,5,5,12,50,1.417386,0,0
371830525033006,2,5,5,12,202,1.366873,0,0
371830538083002,1,4,4,9,109,0.454469,0.002632,0.000288
371830527052008,1,4,4,9,155,0.213946,0.004763,0.000215
371830540131013,2,5,5,12,160,1.42088,0,0
371830530081020,2,1,5,8,64,1.242879,0.033889,7.2e-05
371830527073020,2,4,4,10,106,1.139417,0.011337,0.000103
371830528064032,3,5,5,13,4,1.824136,0,0
371830545001030,1,3,3,7,33,0.205441,0.020133,0.000728
371830501001088,1,2,1,4,538,0.062504,0.022887,0.001623
371830506003012,1,4,1,6,49,0.145554,0.00974,0.001781
371830536101043,2,4,4,10,82,1.035122,0.001964,0.000197
371830526021013,2,4,4,10,68,0.669171,0.002575,0.000102
371830541102033,5,5,5,15,9,4.083503,0,0
371830506002003,1,4,2,7,28,0.140284,0.006785,0.001002
371830527051024,2,4,4,10,39,0.986548,0.004763,0.000215
371830541043038,3,5,5,13,83,1.623902,0,0
370630019002093,5,5,5,15,265,4.497213,0,0
371830537171029,4,5,5,14,132,2.721445,0,0
371830515022018,1,4,4,9,65,0.114712,0.00418,0.000402
371830514004013,2,4,3,9,16,0.693948,0.003018,0.000546
371830525062003,1,3,3,7,26,0.591382,0.013421,0.000543
371830519001017,2,5,4,11,23,0.832859,0.000694,0.000175
371830541052035,2,4,4,10,21,1.178477,0.011337,0.000103
371830541061012,4,5,5,14,55,2.441877,0,0
371830540141069,3,5,5,13,23,1.598245,0,0
371830537241044,3,5,5,13,61,1.910305,0,0
371830507003003,1,4,2,7,9,0.35305,0.00352,0.001079
371830517001003,2,4,3,9,139,0.827105,0.008414,0.000629
371830540112005,2,2,3,7,138,1.100893,0.025679,0.000856
371830541042017,2,1,4,7,60,1.044522,0.03317,0.0002
371830537171007,3,5,5,13,72,2.378025,0,0
371830537231012,2,4,4,10,106,0.891501,0.010065,0.000331
371830537232014,1,5,4,10,76,0.307781,3.5e-05,0.000258
371830528062007,3,5,5,13,73,1.645358,0,0
371830516003015,1,4,4,9,38,0.492373,0.003781,0.000471
371830537121008,2,4,4,10,83,1.230112,0.010065,0.000201
371830514005018,1,4,3,8,33,0.102528,0.00815,0.000695
371830542102029,5,5,5,15,151,3.807923,0,0
371830537073015,2,3,4,9,90,0.780174,0.016673,0.000368
371830540121002,2,4,4,10,86,0.873511,0.007237,0.000104
371830527073003,2,5,5,12,34,1.438379,0,0
371830506003015,1,4,1,6,24,0.017315,0.005684,0.001617
371830505001014,1,4,2,7,41,0.094305,0.006348,0.001093
371830527061004,2,4,4,10,24,1.15157,0.011337,0.000103
371830507003032,1,4,1,6,1,0.273345,0.008514,0.001553
371830537152004,2,5,4,11,20,0.768883,0.001169,0.000134
371830537151010,1,3,4,8,80,0.043578,0.014256,0.000338
371830524011068,2,4,4,10,65,1.283605,0.00124,0.000144
371830540131045,2,1,4,7,125,1.251489,0.076914,0.000488
371830527052015,2,4,4,10,16,1.263146,0.002464,0.000129
371830525043043,2,4,4,10,19,0.735421,0.007505,0.00024
371830541041050,2,1,4,7,90,0.648419,0.03317,0.0002
371830525072026,3,5,5,13,99,1.9689,0,0
371830525042002,1,4,4,9,62,0.129906,0.007597,0.000446
371830527061000,2,5,5,12,162,1.377862,0,0
371830537181001,5,5,5,15,9,4.053142,0,0
371830511012018,1,4,4,9,31,0.608203,0.002587,0.000339
371830541051024,3,5,5,13,2,1.957411,0,0
371830514001003,1,4,3,8,39,0.087127,0.005007,0.000651
371830517002013,1,4,3,8,37,0.629077,0.010742,0.000924
371830540132029,2,4,4,10,89,1.215525,0.002632,0.000288
371830541053010,4,5,5,14,44,2.679631,0,0
371830542071069,4,5,5,14,107,2.753306,0,0
371830524041019,1,1,4,6,44,0.356714,0.035672,0.00032
371830525052012,2,4,4,10,262,0.782081,0.007136,0.00048
371830540182003,3,5,5,13,82,1.549771,0,0
371830519002006,1,4,3,8,405,0.587093,0.00604,0.000543
371830524071005,2,4,4,10,182,0.916873,0.00124,0.000144
371830537241002,3,5,5,13,66,1.960864,0,0
371830515011035,1,4,3,8,30,0.509275,0.008815,0.000626
371830525051002,2,4,5,11,76,1.239078,0.011085,7.7e-05
371830505003013,1,4,4,9,93,0.290373,0.004567,0.000165
371830540141020,2,5,5,12,117,1.334947,0,0
371830518002015,1,4,3,8,58,0.480532,0.007749,0.000585
371830540043014,2,4,4,10,41,1.09623,0.007237,0.000104
371830537171021,4,5,5,14,98,2.659082,0,0
371830503002005,1,2,2,5,288,0.407493,0.022091,0.001118
371830503001016,1,4,3,8,25,0.154521,0.003783,0.000591
371830537221008,2,3,4,9,42,1.227453,0.014312,0.000282
371830523023020,2,4,4,10,3,1.125245,0.00545,0.000141
371830508001008,1,4,1,6,37,0.091128,0.010332,0.001538
371830524082009,1,4,4,9,197,0.377382,0.001737,0.000237
371830501001107,1,2,1,4,20,0.095849,0.027033,0.00199
371830520024005,2,4,2,8,54,0.893017,0.002927,0.001096
371830540171011,3,5,5,13,415,1.544845,0,0
371830525032022,1,4,5,10,6,0.495113,0.004523,9.4e-05
371830523021023,2,5,5,12,29,1.295698,0,0
371830503001025,1,4,3,8,34,0.118662,0.007399,0.000888
371830542071073,3,5,5,13,20,1.970721,0,0
371830537142001,2,5,4,11,130,1.141139,0.001169,0.000134
370630019002083,5,5,5,15,151,4.868176,0,0
371830545002019,1,4,1,6,23,0.539357,0.008963,0.00222
371830542071031,4,5,5,14,92,3.223645,0,0
371830545003019,2,5,5,12,99,1.35382,0,0
371830525071016,2,4,3,9,2,0.775521,0.011078,0.00063
371830524011071,2,4,4,10,39,1.144799,0.00124,0.000144
371830515012003,1,5,5,11,47,0.622719,0.001038,7e-05
371830517002004,2,4,3,9,39,0.863093,0.006392,0.000572
371830528033052,3,5,5,13,16,1.728314,0,0
371830536102013,1,4,4,9,62,0.618449,0.001964,0.000197
371830541051005,4,5,5,14,403,2.510403,0,0
371830528064046,3,5,5,13,16,1.892429,0,0
371830524011003,5,5,5,15,22,3.8047,0,0
371830524082005,1,4,4,9,36,0.241737,0.003827,0.000483
371830510002014,1,2,2,5,37,0.202243,0.024164,0.001052
371830541063033,1,3,4,8,3,0.089507,0.016556,0.000185
370630019002080,5,5,5,15,44,4.743165,0,0
371830520022003,1,4,3,8,150,0.152435,0.001939,0.000791
371830507002007,1,4,1,6,45,0.045558,0.008715,0.001503
371830537241020,3,5,5,13,35,2.253116,0,0
371830528062051,2,5,5,12,43,1.489888,0,0
371830540134026,3,5,5,13,37,1.796395,0,0
371830520012002,3,5,5,13,116,1.573663,0,0
371830536101050,3,5,5,13,398,1.843581,0,0
370630019002096,5,5,5,15,122,4.023311,0,0
371830515022023,1,4,3,8,39,0.084321,0.004548,0.000541
371830505001007,1,4,2,7,47,0.312443,0.006368,0.001067
371830528072073,1,4,4,9,285,0.571652,0.010303,0.000189
371830541043044,2,1,4,7,80,0.997823,0.03317,0.0002
371830521014020,1,3,3,7,17,0.401396,0.013541,0.00076
371830523013026,2,5,5,12,437,1.493693,0,0
371830527011015,1,4,4,9,20,0.46069,0.002575,0.000102
371830540062001,2,5,5,12,237,1.319145,0,0
371830540132020,2,4,4,10,46,0.98551,0.002632,0.000288
371830518001029,1,4,4,9,25,0.167115,0.003177,0.000397
371830542102043,5,5,5,15,32,3.788994,0,0
371830540141046,2,4,4,10,26,0.674125,0.001332,0.00017
371830537161005,1,3,4,8,202,0.446373,0.014256,0.000338
371830540143020,2,4,4,10,122,1.280935,0.001332,0.00017
371830528064058,2,5,5,12,32,1.38574,0,0
371830542102032,5,5,5,15,87,4.433176,0,0
371830508001017,1,4,1,6,61,0.048011,0.010426,0.001687
371830540134007,2,1,4,7,26,1.271754,0.076914,0.000488
371830537111002,3,5,5,13,95,1.667359,0,0
371830537252029,3,5,5,13,41,1.709125,0,0
371830542071027,4,5,5,14,16,2.968969,0,0
371830540134017,2,5,5,12,75,1.366006,0,0
371830516004006,2,4,4,10,1,0.642266,0.003116,0.0003
371830528033036,2,4,4,10,66,1.001612,0.003839,0.000257
371830537221002,2,4,4,10,37,0.72078,0.010065,0.000201
371830537113014,2,3,4,9,60,0.844747,0.015181,0.000348
371830525043029,2,4,5,11,68,0.636636,0.004523,9.4e-05
371830527063001,3,5,5,13,3,1.781238,0,0
371830520022002,1,4,3,8,120,0.461785,0.003631,0.000916
371830530081063,3,5,5,13,31,1.815622,0,0
371830507003008,1,4,2,7,17,0.164614,0.004141,0.000999
371830518001010,2,4,4,10,94,0.688344,0.004919,0.000462
371830525033000,3,5,5,13,138,2.33981,0,0
371830541103016,5,5,5,15,30,4.81298,0,0
371830528062010,4,5,5,14,199,2.47389,0,0
371830537251021,2,3,4,9,222,1.058249,0.012746,0.000229
371830523023012,2,4,4,10,26,0.981752,0.00545,0.000141
371830518003012,1,4,4,9,41,0.507759,0.004919,0.000462
371830541063019,1,3,4,8,175,0.064645,0.016556,0.000185
371830542091078,5,5,5,15,2,3.495628,0,0
371830537241017,3,5,5,13,207,1.670981,0,0
371830537241029,3,5,5,13,37,2.039959,0,0
371830519003005,1,4,4,9,40,0.062104,0.005013,0.000387
371830510001008,1,3,3,7,3,0.362731,0.021718,0.000727
371830542071026,4,5,5,14,101,2.569496,0,0
371830537251013,2,3,4,9,39,0.716822,0.012746,0.000229
371830540141033,2,4,4,10,313,1.226487,0.001332,0.00017
371830527011002,1,4,4,9,67,0.551574,0.005234,0.000171
371830540171015,2,5,5,12,14,1.422261,0,0
371830521021033,2,4,4,10,167,0.922568,0.003839,0.000257
371830541063023,1,3,4,8,30,0.119347,0.016556,0.000185
371830512003021,1,2,3,6,61,0.230906,0.022962,0.00065
371830510001012,1,3,3,7,132,0.228859,0.021718,0.000727
371830545003025,2,5,5,12,56,1.299813,0,0
371830537252023,3,5,5,13,117,1.840258,0,0
371830516002016,1,4,4,9,42,0.357222,0.002962,0.000222
371830540141096,2,4,4,10,96,0.71183,0.001332,0.00017
371830527042002,1,4,5,10,58,0.285803,0.002298,8.6e-05
371830540084000,2,4,4,10,427,1.274813,0.003023,0.000139
371830527043003,2,4,5,11,246,0.694145,0.002298,8.6e-05
371830524011061,2,5,5,12,2,1.346645,0,0
371830506002026,1,4,2,7,8,0.259535,0.00702,0.001106
371830540141024,3,5,5,13,74,1.610239,0,0
371830525043009,1,4,4,9,4,0.305957,0.007597,0.000446
371830538082012,2,4,4,10,3,1.047981,0.010065,0.000201
371830537093023,3,5,5,13,22,2.268535,0,0
371830525043012,1,4,4,9,167,0.386608,0.007505,0.00024
371830537232005,1,5,4,10,200,0.273642,0,0.00013
371830526021022,2,4,4,10,54,0.726072,0.005234,0.000171
371830540141051,2,4,4,10,62,0.774982,0.001332,0.00017
371830503001006,1,4,4,9,47,0.32304,0.003822,0.000417
371830524062006,3,5,5,13,8,2.224648,0,0
371830537093042,4,5,5,14,5,2.732322,0,0
371830528072030,2,4,4,10,97,0.82567,0.010303,0.000189
371830526031009,2,4,4,10,660,0.884763,0.008373,0.000528
371830536101034,3,5,5,13,86,1.834854,0,0
371830537092026,2,5,5,12,7,1.31476,0,0
371830510001014,1,3,3,7,24,0.436133,0.021651,0.000886
371830537072015,1,3,4,8,13,0.322914,0.012254,0.000341
371830524041013,1,1,4,6,28,0.407898,0.036848,0.0004
371830537143015,2,5,4,11,175,0.974922,0.001169,0.000134
371830540141027,3,5,5,13,56,1.630351,0,0
371830540141065,2,5,5,12,82,1.420778,0,0
371830524062025,3,5,5,13,147,1.839474,0,0
371830537241073,2,4,4,10,187,1.010933,0.0085,0.000147
371830518002000,1,4,4,9,127,0.272974,0.004919,0.000462
371830526031016,1,4,3,8,20,0.355867,0.009064,0.000828
371830538071021,2,4,4,10,269,0.718823,0.010065,0.000201
371830540043004,1,4,4,9,77,0.597562,0.007237,0.000104
371830508001020,1,4,1,6,4,0.081063,0.008596,0.001405
371830528033017,3,5,5,13,119,1.572273,0,0
371830516001020,1,4,4,9,73,0.519193,0.004688,0.000458
371830541043030,2,5,5,12,67,1.451234,0,0
371830511012010,2,4,4,10,71,0.68556,0.002044,0.000235
371830527072022,1,4,4,9,104,0.34213,0.011337,0.000103
371830540151024,2,5,5,12,50,1.385347,0,0
371830524063001,4,5,5,14,64,2.736517,0,0
371830528033019,2,5,5,12,14,1.392133,0,0
371830537221006,2,4,5,11,56,1.213149,0.004246,8.2e-05
371830541131017,5,5,5,15,26,4.571902,0,0
371830527072021,2,4,4,10,56,0.858588,0.011337,0.000103
371830541102048,3,5,5,13,30,1.665393,0,0
371830537113003,1,3,4,8,69,0.18474,0.012746,0.000229
371830519002010,1,4,3,8,53,0.51844,0.00604,0.000543
371830541054013,2,4,4,10,355,1.236991,0.011337,0.000103
371830527063020,3,5,5,13,178,2.375517,0,0
371830537222008,2,5,4,11,52,1.176859,0,0.00013
371830516001017,2,4,3,9,3,0.696714,0.005339,0.000661
371830521021029,1,4,4,9,102,0.237026,0.004318,0.000372
371830515022010,1,4,4,9,161,0.49899,0.002668,0.000341
371830541102024,5,5,5,15,6,3.871822,0,0
371830528072006,2,4,4,10,10,0.812538,0.010303,0.000189
371830540171018,3,5,5,13,523,1.586892,0,0
371830537112003,2,4,4,10,54,0.947624,0.0085,0.000147
371830524011096,3,5,5,13,2,1.981203,0,0
371830540082010,2,4,4,10,175,1.241939,0.005321,0.000225
371830528064017,3,5,5,13,89,1.610524,0,0
371830537162000,1,3,4,8,719,0.225854,0.014256,0.000338
371830528072008,2,4,4,10,13,0.837333,0.010303,0.000189
371830525051009,2,4,5,11,36,0.943592,0.011085,7.7e-05
371830503001014,1,4,4,9,44,0.220011,0.003694,0.000394
371830527063004,3,5,5,13,92,1.850676,0,0
371830501001106,1,2,1,4,127,0.164399,0.027033,0.00199
371830527063024,3,5,5,13,10,2.178506,0,0
371830511021012,1,2,3,6,90,0.110818,0.022962,0.000586
371830537111011,3,5,5,13,49,1.695724,0,0
371830540112001,2,2,3,7,30,0.727616,0.025679,0.000856
371830524011058,2,5,5,12,2,1.405114,0,0
371830541061003,2,3,4,9,75,1.027434,0.016556,0.000185
371830509002016,1,2,1,4,1,0.149218,0.026774,0.001651
371830527043012,1,4,4,9,111,0.247362,0.004763,0.000215
371830515022008,1,4,4,9,95,0.136187,0.00418,0.000402
371830530081017,2,1,5,8,62,1.282569,0.033889,7.2e-05
371830537122006,3,5,5,13,152,1.534072,0,0
371830518002030,1,4,4,9,10,0.315161,0.004864,0.000518
371830508002005,1,4,3,8,91,0.322379,0.006118,0.00072
371830526032001,1,4,3,8,72,0.631654,0.008856,0.000655
371830537152013,2,3,4,9,27,1.036152,0.012254,0.000211
371830528062001,3,5,5,13,131,1.698233,0,0
371830541055011,3,5,5,13,31,1.700795,0,0
371830505001028,1,4,2,7,34,0.224568,0.007032,0.001202
371830521014025,1,3,3,7,53,0.552577,0.014794,0.000604
371830536102031,1,4,4,9,137,0.428087,0.001964,0.000197
371830537192000,5,5,5,15,73,4.549639,0,0
371830524072004,1,4,4,9,71,0.59737,0.001783,0.000248
371830542102041,5,5,5,15,114,3.806991,0,0
371830519001041,1,4,3,8,49,0.371189,0.005806,0.00079
371830527051017,2,4,4,10,8,0.69677,0.002464,0.000129
371830542071063,3,5,5,13,61,2.392297,0,0
371830540134000,3,5,5,13,1632,1.569494,0,0
371830523023015,2,4,4,10,114,1.073362,0.00545,0.000141
371830545003022,2,4,4,10,98,0.932757,0.00545,0.000141
371830506003000,1,4,1,6,85,0.252752,0.008379,0.001499
371830515012013,2,4,4,10,199,0.96669,0.004201,0.000326
371830540083000,2,4,4,10,92,0.650256,0.003023,0.000139
371830540132007,2,5,5,12,189,1.360557,0,0
371830518002021,1,4,4,9,38,0.2405,0.004919,0.000462
371830507001011,1,4,1,6,31,0.05537,0.006573,0.00174
371830540112007,2,5,5,12,56,1.328254,0,0
371830540081005,1,4,4,9,408,0.476629,0.003023,0.000139
371830521013009,2,3,4,9,35,0.974463,0.013469,0.000454
371830541054021,1,4,4,9,48,0.234147,0.011337,0.000103
371830541054005,2,4,4,10,8,1.233398,0.011337,0.000103
371830524091000,1,4,4,9,418,0.325418,0.004034,0.000175
371830521022001,1,4,4,9,47,0.615044,0.004318,0.000372
371830537121009,2,5,5,12,60,1.317,0,0
371830541044011,2,4,4,10,46,1.054412,0.011337,0.000103
371830537111005,3,5,5,13,23,1.960174,0,0
371830540162008,1,1,4,6,36,0.632291,0.059635,0.000247
371830521011014,2,4,4,10,3,1.068346,0.007092,0.000256
371830542071065,3,5,5,13,26,2.361254,0,0
371830507002005,1,4,1,6,36,0.219045,0.003856,0.001477
371830537093057,3,5,5,13,8,2.421166,0,0
371830527072003,2,3,4,9,31,1.070466,0.013635,0.000189
371830523023026,2,4,4,10,80,0.868425,0.00545,0.000141
371830528033006,2,5,5,12,51,1.451202,0,0
371830541052009,3,5,5,13,4,1.984194,0,0
371830537252036,3,5,5,13,7,1.724245,0,0
371830537241037,3,5,5,13,61,1.719338,0,0
371830525072025,3,5,5,13,19,1.766007,0,0
371830540043000,1,4,4,9,26,0.468159,0.007237,0.000104
371830525051008,2,5,5,12,29,1.494677,0,0
371830514003009,1,4,3,8,38,0.496314,0.004665,0.000633
371830501001068,1,2,1,4,7,0.013588,0.023437,0.001796
371830528061002,2,4,4,10,286,1.163855,0.010303,0.000189
371830541051022,3,5,5,13,39,2.157693,0,0
371830537122014,1,4,5,10,134,0.40875,0.004246,8.2e-05
371830501001054,1,2,1,4,41,0.096516,0.024143,0.002048
371830501001055,1,2,1,4,1,0.144131,0.023137,0.001969
371830527073031,2,5,5,12,106,1.317951,0,0
371830538082007,3,5,5,13,67,1.845934,0,0
371830526022009,1,4,4,9,35,0.356359,0.002575,0.000102
371830528033002,3,5,5,13,87,1.783958,0,0
371830524072007,2,1,4,7,232,1.144521,0.034432,0.000176
371830541131002,3,5,5,13,104,1.690084,0,0
371830537222003,2,5,4,11,120,1.147364,0,0.00013
371830527072006,2,3,4,9,21,1.036396,0.013802,0.000231
371830507001013,1,4,1,6,114,0.09296,0.010436,0.001831
371830524062027,2,4,4,10,2,1.159488,0.00124,0.000144
371830537192005,5,5,5,15,126,4.228155,0,0
371830523023016,2,5,5,12,113,1.483857,0,0
371830521011030,2,4,4,10,52,0.96955,0.002993,0.000222
371830541055008,2,5,5,12,27,1.385618,0,0
371830528062038,3,5,5,13,66,2.337576,0,0
371830524063014,4,5,5,14,48,2.702942,0,0
371830541102016,5,5,5,15,32,3.665572,0,0
371830537111033,2,4,5,11,13,0.634065,0.004246,8.2e-05
371830504001022,1,4,3,8,66,0.069836,0.002179,0.00071
371830528072055,5,5,5,15,15,3.707643,0,0
371830540131028,2,5,5,12,45,1.392317,0,0
371830514005002,1,4,3,8,80,0.296244,0.005107,0.000533
371830527073036,3,5,5,13,85,1.817027,0,0
371830545004019,2,5,5,12,36,1.345837,0,0
371830541042020,3,5,5,13,152,1.651827,0,0
371830541041019,2,5,5,12,2,1.462859,0,0
371830521011000,1,4,4,9,35,0.128832,0.010931,0.000513
371830526021010,2,4,4,10,132,1.070354,0.005234,0.000171
371830537232002,2,5,4,11,18,0.724024,0,0.00013
371830536102045,1,4,4,9,8,0.423561,0.001964,0.000197
371830528061028,2,5,5,12,74,1.464863,0,0
371830528072010,2,4,4,10,36,0.978528,0.010303,0.000189
371830501001092,1,2,1,4,31,0.018671,0.023804,0.001927
371830541102043,2,1,4,7,3,1.065407,0.03317,0.0002
371830538082008,2,2,3,7,82,1.26072,0.025679,0.000856
371830528033051,2,5,5,12,92,1.512527,0,0
371830524081003,2,4,4,10,22,0.654583,0.003827,0.000483
371830507001014,1,4,1,6,19,0.195853,0.007894,0.001742
371830516003006,1,4,4,9,1,0.599809,0.005304,0.000526
371830545003016,3,5,5,13,23,1.650796,0,0
371830524042001,2,1,4,7,303,0.962942,0.035084,0.000204
371830530091001,2,5,5,12,9,1.388554,0,0
371830519002016,1,4,3,8,12,0.617459,0.00611,0.000614
371830505003014,1,4,5,10,42,0.306061,0.003562,8.6e-05
371830541102001,4,5,5,14,36,3.117199,0,0
371830528064025,1,4,4,9,18,0.462519,0.010303,0.000189
371830540141049,2,4,4,10,196,0.827256,0.001332,0.00017
371830540142003,1,4,4,9,18,0.12261,0.001332,0.00017
371830537072006,2,5,4,11,33,0.733042,0.001204,0.000392
371830537121002,2,4,5,11,249,0.886654,0.004246,8.2e-05
371830511012007,1,4,4,9,151,0.511243,0.002044,0.000235
371830527071013,2,4,4,10,39,1.00584,0.011337,0.000103
371830528033046,3,5,5,13,293,1.926555,0,0
371830503001017,1,4,3,8,26,0.079376,0.004026,0.000651
371830524081002,1,4,4,9,249,0.608628,0.002044,0.000235
371830540141093,2,4,4,10,120,0.921893,0.001332,0.00017
371830527062019,3,5,5,13,87,2.305762,0,0
371830527061012,2,5,5,12,76,1.380269,0,0
371830537073013,1,3,4,8,57,0.589694,0.016673,0.000368
371830537241024,2,5,5,12,58,1.406684,0,0
371830536101040,2,5,5,12,60,1.389955,0,0
371830541041001,3,5,5,13,2,2.035754,0,0
371830525042010,2,4,4,10,79,0.89861,0.007505,0.00024
371830520024007,1,4,3,8,17,0.615499,0.002234,0.000831
371830542091070,4,5,5,14,88,3.244719,0,0
371830503002001,1,2,2,5,105,0.33455,0.022704,0.001378
371830542071064,3,5,5,13,117,1.992339,0,0
371830537093050,3,5,5,13,32,2.228649,0,0
371830540043006,2,4,4,10,125,0.746006,0.007237,0.000104
371830528062050,3,5,5,13,2,1.636109,0,0
371830515022004,1,4,4,9,43,0.086721,0.00418,0.000402
371830540141083,2,5,5,12,52,1.397597,0,0
371830520022008,1,4,3,8,132,0.132239,0.001467,0.000655
371830505003016,1,4,4,9,21,0.081969,0.004567,0.000165
371830542091075,4,5,5,14,73,2.832499,0,0
371830540062003,2,4,4,10,305,0.941829,0.005588,0.000292
371830527072000,1,4,4,9,176,0.553244,0.011337,0.000103
371830518003016,1,4,4,9,45,0.420571,0.004919,0.000462
371830524063020,3,5,5,13,266,2.019,0,0
371830526032016,2,4,3,9,32,0.680306,0.008856,0.000655
371830540161003,2,1,4,7,15,0.941315,0.059635,0.000247
371830541041049,2,1,4,7,48,0.787539,0.03317,0.0002
371830542081128,2,4,4,10,59,1.207996,0.002632,0.000288
371830519001014,1,4,3,8,78,0.284279,0.005318,0.000602
371830537222000,2,4,4,10,84,0.92949,0.010065,0.000331
371830524011072,2,4,4,10,5,0.996991,0.00124,0.000144
371830537181023,5,5,5,15,32,3.726889,0,0
371830536102111,1,4,4,9,34,0.24528,0.001964,0.000197
371830545003026,3,5,5,13,29,1.593418,0,0
371830540162027,3,5,5,13,58,1.721758,0,0
371830537163007,1,3,4,8,44,0.32868,0.016915,0.000407
371830505001022,1,4,1,6,20,0.125343,0.00986,0.001599
371830541051020,3,5,5,13,195,2.011886,0,0
371830540182005,2,4,4,10,26,1.220027,0.007237,0.000104
371830537222002,2,5,5,12,72,1.360505,0,0
371830527051008,1,4,4,9,81,0.229503,0.004763,0.000215
371830525062000,2,4,4,10,226,1.030236,0.010986,0.000424
371830540131030,2,1,4,7,61,1.15235,0.076914,0.000488
371830537092022,2,4,4,10,44,1.255483,0.002435,0.000119
371830537262016,2,4,4,10,28,0.701769,0.002435,0.000119
371830542071030,4,5,5,14,80,3.037002,0,0
371830541051001,3,5,5,13,403,2.097457,0,0
371830528033054,2,5,5,12,3,1.3181,0,0
371830541063007,2,5,5,12,211,1.360032,0,0
371830510002013,1,2,2,5,34,0.233465,0.026086,0.001177
371830537171020,4,5,5,14,836,2.470948,0,0
371830537251009,2,3,4,9,125,0.863038,0.012746,0.000229
371830540134005,3,5,5,13,99,1.817297,0,0
371830521022002,1,4,4,9,50,0.602882,0.004318,0.000372
371830517002008,1,4,3,8,45,0.597218,0.00923,0.000863
371830540141010,3,5,5,13,97,1.864478,0,0
371830541131015,5,5,5,15,18,4.655553,0,0
371830537241085,3,5,5,13,193,1.784627,0,0
371830528062000,3,5,5,13,306,1.64992,0,0
371830524011052,3,5,5,13,26,2.416938,0,0
371830508002000,1,4,2,7,71,0.294008,0.007471,0.001026
371830537113017,2,3,4,9,57,0.917688,0.015181,0.000348
371830521012008,1,4,4,9,29,0.123663,0.010931,0.000513
371830536102027,1,4,4,9,72,0.395144,0.001964,0.000197
371830535211000,4,5,5,14,136,3.145045,0,0
371830525033003,3,5,5,13,30,2.152187,0,0
371830519002018,1,4,3,8,44,0.542662,0.006323,0.000681
371830525072027,3,5,5,13,39,1.961007,0,0
371830526032008,1,3,2,6,150,0.484828,0.013167,0.001056
371830541103007,5,5,5,15,235,3.780952,0,0
371830537142010,2,4,4,10,91,0.717669,0.002435,0.000119
371830537093049,3,5,5,13,33,2.406114,0,0
371830541102049,3,5,5,13,39,1.761768,0,0
371830524082000,1,5,4,10,167,0.174442,0.001195,0.000132
371830506003023,1,4,1,6,39,0.063118,0.005849,0.001687
371830541043032,3,5,5,13,142,1.902447,0,0
371830514001001,1,4,4,9,43,0.346933,0.003816,0.00053
371830526023007,2,4,4,10,36,0.966662,0.002575,0.000102
371830540162006,2,5,5,12,295,1.369594,0,0
371830537231002,2,4,4,10,234,0.830441,0.010065,0.000201
371830537211038,2,4,4,10,64,1.06921,0.010065,0.000201
371830524082003,1,5,4,10,835,0.323737,0.001195,0.000132
371830527052000,1,4,4,9,53,0.348103,0.004763,0.000215
371830520012015,2,4,3,9,110,0.685261,0.002202,0.000697
371830541043001,3,5,5,13,210,1.568987,0,0
371830520023005,1,4,4,9,37,0.340495,0.006846,0.000189
371830525062007,2,4,4,10,28,1.057541,0.002435,0.000119
371830514005006,1,4,3,8,31,0.10373,0.00815,0.000695
371830541053001,3,5,5,13,48,2.084439,0,0
371830515011024,1,4,4,9,43,0.308806,0.007136,0.00048
371830545004004,3,5,5,13,81,1.535793,0,0
371830540013004,2,4,4,10,4,0.729394,0.009896,0.000173
371830505002003,1,4,3,8,381,0.416239,0.005338,0.000856
371830509001008,1,2,1,4,13,0.087301,0.025559,0.001523
371830523011019,2,1,5,8,50,0.998177,0.033889,7.2e-05
371830541053015,3,5,5,13,100,2.261723,0,0
371830515022027,1,4,4,9,55,0.536385,0.00418,0.000402
371830521021037,1,4,4,9,37,0.472221,0.004318,0.000372
371830523011017,1,1,5,7,33,0.414894,0.033889,7.2e-05
371830541054022,2,4,4,10,2,1.207087,0.011337,0.000103
371830527043018,1,4,4,9,86,0.455445,0.004763,0.000215
371830514003013,1,4,3,8,75,0.590298,0.007505,0.000675
371830514004002,1,4,3,8,50,0.574314,0.007505,0.000675
371830542071024,4,5,5,14,159,2.896286,0,0
371830521011012,2,4,4,10,9,1.145007,0.007092,0.000256
371830515022002,1,4,4,9,28,0.274198,0.002668,0.000341
371830542071107,2,5,5,12,44,1.410039,0,0
371830528072082,1,4,4,9,30,0.501059,0.010303,0.000189
371830507003011,1,4,2,7,16,0.369828,0.004366,0.001022
371830523013013,2,1,5,8,209,0.961254,0.033889,7.2e-05
371830540181033,2,4,5,11,2,0.895998,0.002298,8.6e-05
371830541043035,2,5,5,12,37,1.384414,0,0
371830518003017,1,4,4,9,277,0.233827,0.004919,0.000462
371830540143037,2,5,5,12,23,1.466156,0,0
371830536101029,3,5,5,13,20,1.886673,0,0
371830536101013,3,5,5,13,89,1.98917,0,0
371830503002015,1,2,2,5,34,0.51738,0.022163,0.00099
371830528064015,3,5,5,13,674,1.896286,0,0
371830505001015,1,4,2,7,28,0.090882,0.00582,0.000981
371830503001031,1,4,3,8,25,0.189016,0.007481,0.000848
371830527043002,2,4,5,11,225,0.740549,0.002298,8.6e-05
371830542081087,3,5,5,13,29,2.083372,0,0
371830512001001,1,4,3,8,29,0.540783,0.006861,0.000633
371830520021014,2,4,4,10,45,0.797604,0.007093,0.000528
371830527073000,1,4,4,9,74,0.233446,0.011337,0.000103
371830540141087,2,4,4,10,152,1.253718,0.003023,0.000139
371830521014027,1,3,4,8,77,0.527833,0.01228,0.000497
371830537141007,2,4,5,11,27,1.231612,0.004246,8.2e-05
371830525061016,1,4,4,9,7,0.601417,0.010986,0.000424
371830540043001,1,4,4,9,66,0.335614,0.007237,0.000104
371830540011006,1,4,5,10,24,0.397734,0.002659,6.9e-05
371830540143003,3,5,5,13,114,1.938498,0,0
371830518002019,1,4,4,9,41,0.207393,0.006237,0.000524
371830537191010,5,5,5,15,114,3.962583,0,0
371830538083032,1,4,4,9,2,0.386347,0.002632,0.000288
371830528062035,3,5,5,13,148,2.150487,0,0
371830516002017,1,4,4,9,39,0.314091,0.002962,0.000222
371830540151046,1,4,4,9,11,0.488938,0.003023,0.000139
371830540143006,2,5,5,12,39,1.458295,0,0
371830524041029,1,1,4,6,10,0.416427,0.036848,0.0004
371830505001008,1,4,2,7,30,0.064039,0.006389,0.001144
371830501001003,1,4,1,6,23,0.252342,0.006475,0.001573
371830505002020,1,4,3,8,66,0.365493,0.005984,0.00081
371830545003003,2,4,2,8,28,1.060101,0.007829,0.001125
371830516005007,1,4,4,9,37,0.464766,0.004688,0.000458
371830537162003,1,3,4,8,64,0.245738,0.015425,0.000472
371830542071075,3,5,5,13,55,2.254057,0,0
371830537122018,1,4,5,10,73,0.254068,0.004246,8.2e-05
371830540121012,2,4,4,10,335,0.904652,0.007237,0.000104
371830540171057,2,5,5,12,26,1.471813,0,0
371830541102037,5,5,5,15,17,3.585383,0,0
371830537071025,1,3,4,8,53,0.377838,0.012254,0.000211
371830540134034,3,5,5,13,74,1.772134,0,0
370630019002097,5,5,5,15,178,4.065722,0,0
371830541043037,3,5,5,13,60,1.620806,0,0
371830537252004,2,5,5,12,72,1.40321,0,0
371830501001019,1,4,1,6,22,0.217413,0.006461,0.001721
371830525052013,2,4,4,10,64,1.181808,0.004153,0.000334
371830505001006,1,4,3,8,50,0.14767,0.006202,0.000919
371830538083029,1,4,4,9,7,0.430138,0.002632,0.000288
371830537112016,2,4,4,10,21,1.031986,0.0085,0.000147
371830528062015,3,5,5,13,21,1.688515,0,0
371830540163019,2,5,5,12,24,1.528335,0,0
371830518001020,1,4,4,9,45,0.41497,0.004919,0.000462
371830528033003,3,5,5,13,140,1.842093,0,0
371830516002008,2,4,4,10,22,1.027032,0.00255,0.000131
371830523023003,2,4,4,10,49,0.740151,0.00545,0.000141
371830541053019,4,5,5,14,301,2.719713,0,0
371830515012025,2,4,4,10,164,0.898655,0.004201,0.000326
371830507003028,1,4,1,6,25,0.141654,0.008514,0.001492
371830525032003,2,4,5,11,76,0.861074,0.004523,9.4e-05
371830527061005,2,4,4,10,57,1.203459,0.011337,0.000103
371830521021049,2,5,5,12,20,1.432065,0,0
371830527073030,2,5,5,12,2,1.362438,0,0
371830526023001,2,4,4,10,94,0.912736,0.005234,0.000171
371830527073035,3,5,5,13,107,1.929306,0,0
371830527051015,1,4,4,9,40,0.42567,0.002464,0.000129
371830501001018,1,4,1,6,53,0.221269,0.006461,0.001721
371830540142006,1,4,4,9,86,0.218537,0.001332,0.00017
371830515022014,1,4,4,9,47,0.54483,0.002668,0.000341
371830538082010,3,5,5,13,69,1.552851,0,0
371830541042012,2,1,4,7,5,1.257657,0.03317,0.0002
371830515022013,2,4,4,10,47,0.664232,0.002668,0.000341
371830542071110,2,5,5,12,786,1.491398,0,0
371830541042023,1,1,4,6,173,0.395105,0.03317,0.0002
371830516004000,2,4,4,10,25,0.768099,0.002704,0.000209
371830512001003,1,4,3,8,10,0.440066,0.0067,0.000533
371830537141004,2,4,5,11,60,0.963814,0.004246,8.2e-05
371830524093000,1,4,4,9,5,0.323573,0.004034,0.000175
371830527012022,2,4,4,10,100,0.945333,0.007337,0.000317
371830515011032,1,4,4,9,65,0.601902,0.007597,0.000446
371830519002005,1,4,3,8,106,0.36441,0.00604,0.000543
371830527043015,1,4,4,9,19,0.298905,0.004763,0.000215
370630019002079,5,5,5,15,23,5.038198,0,0
371830516003004,1,4,4,9,12,0.524292,0.004725,0.000477
371830514003000,1,4,3,8,288,0.443432,0.005856,0.000753
371830540142008,1,4,4,9,10,0.599642,0.001332,0.00017
371830519002007,2,4,3,9,113,0.651388,0.00604,0.000543
371830538083030,2,4,4,10,108,0.737622,0.002632,0.000288
371830540062002,2,5,5,12,143,1.351177,0,0
371830540131049,2,1,4,7,117,1.175764,0.076914,0.000488
371830514005015,1,4,3,8,29,0.094219,0.00815,0.000695
371830523013010,2,1,5,8,35,0.805617,0.033889,7.2e-05
371830541041029,2,4,4,10,1,1.263938,0.003023,0.000139
371830527052005,1,4,4,9,73,0.200822,0.004763,0.000215
371830525061018,1,4,4,9,44,0.38609,0.010986,0.000424
371830536101077,2,5,5,12,33,1.484188,0,0
371830524081009,1,4,4,9,306,0.37254,0.002044,0.000235
371830540132039,3,5,5,13,181,1.757158,0,0
371830516003011,2,4,4,10,182,0.635905,0.003194,0.000355
371830540141073,2,4,4,10,126,1.280433,0.001332,0.00017
371830525043028,2,4,5,11,16,0.632754,0.004523,9.4e-05
371830541131004,5,5,5,15,146,4.272468,0,0
371830541052007,2,4,4,10,57,1.251332,0.011337,0.000103
371830511012005,1,5,4,10,31,0.399687,0.000868,0.000154
371830519002012,1,4,3,8,50,0.607606,0.00604,0.000543
371830527072028,2,4,4,10,6,1.091095,0.011337,0.000103
371830537111026,3,5,5,13,78,2.091283,0,0
371830541101011,4,5,5,14,59,3.267292,0,0
371830508003004,1,4,2,7,87,0.161458,0.00849,0.001388
371830542071034,3,5,5,13,36,2.336499,0,0
371830537132000,1,4,5,10,51,0.332125,0.004246,8.2e-05
371830504001023,1,4,3,8,75,0.382405,0.005523,0.000687
371830542081123,2,4,4,10,73,1.269191,0.002632,0.000288
371830527063003,3,5,5,13,80,1.656288,0,0
371830516004010,1,4,3,8,46,0.168257,0.004548,0.000541
371830537152006,2,3,4,9,308,0.88699,0.01352,0.000195
371830518002011,1,4,4,9,13,0.354066,0.004919,0.000462
371830537231005,2,4,4,10,363,0.963641,0.010065,0.000331
371830514004015,1,4,3,8,944,0.487113,0.006851,0.000685
371830540134014,3,5,5,13,112,2.015137,0,0
371830537152003,2,5,4,11,56,0.789404,0.001169,0.000134
371830541101002,4,5,5,14,127,2.926267,0,0
371830540162010,1,1,4,6,92,0.597854,0.059635,0.000247
371830540151037,1,4,4,9,115,0.183428,0.003023,0.000139
371830514001010,1,4,3,8,23,0.185619,0.005134,0.000592
371830515012002,2,4,4,10,35,1.020004,0.004021,0.000216
371830541043010,3,5,5,13,246,1.574042,0,0
371830540111012,3,5,5,13,55,1.6614,0,0
371830537162005,2,3,4,9,50,0.961735,0.014256,0.000338
371830506002004,1,4,2,7,30,0.192675,0.006626,0.00099
371830524093007,1,5,4,10,249,0.451333,0.001195,0.000132
371830527013010,2,4,4,10,84,0.94744,0.003061,0.000127
371830540134015,2,1,4,7,35,1.194359,0.076914,0.000488
371830537131012,2,4,4,10,35,0.691133,0.002435,0.000119
371830541044004,2,5,5,12,55,1.394897,0,0
371830537181006,5,5,5,15,109,4.220528,0,0
371830541043025,3,5,5,13,133,1.852823,0,0
371830540142001,1,4,4,9,275,0.256723,0.001332,0.00017
371830519001037,1,4,3,8,51,0.228415,0.006681,0.00086
371830526011011,2,3,4,9,76,1.023505,0.015147,0.000204
371830540082012,2,4,4,10,22,1.17169,0.005321,0.000225
371830508002003,1,4,2,7,151,0.254638,0.0098,0.001109
371830541053012,4,5,5,14,226,2.478767,0,0
371830527012026,2,4,4,10,13,1.085583,0.005039,0.00023
371830527043004,1,4,5,10,369,0.618443,0.002298,8.6e-05
371830507001010,1,4,1,6,151,0.066733,0.005204,0.001675
371830536101088,3,5,5,13,2,1.904004,0,0
371830527063019,3,5,5,13,156,2.043731,0,0
371830541102047,5,5,5,15,87,3.415822,0,0
371830537072020,1,3,3,7,159,0.329805,0.01546,0.0006
371830520011007,2,5,5,12,222,1.526039,0,0
371830512003019,1,2,3,6,25,0.163051,0.023205,0.000709
371830527071008,2,3,4,9,93,1.101342,0.013635,0.000189
371830540141050,2,4,4,10,26,0.785255,0.001332,0.00017
371830542102044,5,5,5,15,245,3.907289,0,0
371830503001021,1,4,3,8,2,0.120782,0.007202,0.0008
371830518001023,1,4,4,9,23,0.595854,0.004919,0.000462
371830537093007,3,5,5,13,93,2.220302,0,0
371830505002022,1,4,4,9,46,0.365915,0.00498,0.000435
371830545002021,1,3,1,5,34,0.450149,0.011601,0.002482
371830530081016,2,1,5,8,7,1.180312,0.033889,7.2e-05
371830527013000,1,4,4,9,98,0.548036,0.002575,0.000102
371830537224005,1,5,4,10,146,0.12444,0,0.00013
371830526011014,2,3,4,9,125,0.945365,0.015147,0.000204
371830525051020,2,4,4,10,4,0.691214,0.007136,0.00048
371830537121001,2,5,5,12,82,1.521255,0,0
371830505002000,1,4,3,8,130,0.100889,0.006659,0.000787
371830541063035,2,3,4,9,72,0.708366,0.016556,0.000185
371830540042001,2,4,4,10,85,0.643622,0.007237,0.000104
371830528033056,3,5,5,13,53,1.675429,0,0
371830514005000,1,4,3,8,214,0.123603,0.00815,0.000695
371830528062049,3,5,5,13,129,1.685293,0,0
371830514003007,2,4,3,9,43,0.786383,0.00453,0.000606
371830528064045,3,5,5,13,95,1.708295,0,0
371830510001011,1,3,3,7,52,0.317989,0.021693,0.000648
371830537191003,5,5,5,15,186,3.644283,0,0
371830527041008,1,4,4,9,1841,0.143266,0.004763,0.000215
371830540132012,3,5,5,13,49,1.535767,0,0
371830541062042,2,3,4,9,31,0.836976,0.016556,0.000185
371830530081035,2,5,5,12,73,1.343654,0,0
371830528062013,3,5,5,13,124,2.314088,0,0
371830541052021,2,5,5,12,132,1.425988,0,0
371830540131005,2,1,3,6,72,1.211692,0.079545,0.000776
371830541131009,5,5,5,15,35,4.617942,0,0
371830516005015,2,4,4,10,111,0.726251,0.003321,0.00036
371830541102020,5,5,5,15,122,4.001977,0,0
371830540142002,1,4,4,9,73,0.215057,0.001332,0.00017
371830509001017,1,2,1,4,101,0.257475,0.027236,0.001877
371830540141047,2,4,4,10,81,0.697131,0.001332,0.00017
371830540132038,3,5,5,13,40,1.547664,0,0
371830540082004,1,4,4,9,44,0.578815,0.003023,0.000139
371830527072023,1,4,4,9,74,0.628766,0.011337,0.000103
371830542071067,4,5,5,14,179,2.852373,0,0
371830540162026,2,5,5,12,90,1.290908,0,0
371830527073016,2,4,4,10,89,0.950775,0.011337,0.000103
371830527073019,2,4,4,10,114,1.101395,0.011337,0.000103
371830537241023,2,5,5,12,36,1.505511,0,0
371830537093004,3,5,5,13,30,2.061128,0,0
371830537241036,3,5,5,13,70,1.907438,0,0
371830537112024,1,3,4,8,17,0.479257,0.012746,0.000229
371830540143000,3,5,5,13,1478,1.559263,0,0
371830540132022,2,4,4,10,86,1.090261,0.002632,0.000288
371830540132037,3,5,5,13,49,1.555501,0,0
371830521014014,1,3,3,7,3,0.299321,0.013062,0.000645
371830545002058,3,5,5,13,18,1.839469,0,0
371830528072071,2,4,4,10,44,0.653856,0.010303,0.000189
371830537142000,2,5,4,11,13,0.883105,0.001169,0.000134
371830537252019,2,5,5,12,36,1.489977,0,0
371830541043034,2,5,5,12,57,1.318012,0,0
371830537222001,2,4,4,10,100,1.107188,0.010065,0.000331
371830542091056,5,5,5,15,104,3.458457,0,0
371830537122003,2,4,4,10,61,1.141594,0.010065,0.000201
371830537151012,1,3,4,8,113,0.170469,0.012254,0.000211
371830503001033,1,4,2,7,24,0.2456,0.007748,0.001394
371830506003021,1,4,1,6,7,0.195753,0.005198,0.001662
371830527013005,1,4,4,9,243,0.485713,0.002575,0.000102
371830538082025,2,4,4,10,4,1.171524,0.010065,0.000201
371830528063013,3,5,5,13,35,2.021602,0,0
371830526011026,1,4,4,9,50,0.154291,0.004062,0.000127
371830540141072,2,5,5,12,8,1.389026,0,0
371830523023036,2,4,4,10,3,1.148844,0.00545,0.000141
371830537211016,3,5,5,13,3,1.544959,0,0
371830541053026,4,5,5,14,43,2.713591,0,0
371830541063004,1,3,4,8,63,0.311936,0.016556,0.000185
371830537093021,3,5,5,13,23,2.230351,0,0
371830540171010,2,1,4,7,10,1.195268,0.059635,0.000247
371830520021005,2,4,4,10,30,0.891287,0.007093,0.000528
371830540121006,3,5,5,13,102,1.680307,0,0
371830537223002,1,4,4,9,167,0.520334,0.010065,0.000201
371830515011001,1,4,4,9,3,0.49738,0.007136,0.00048
371830540132056,2,4,4,10,4,1.238892,0.002632,0.000288
371830507003014,1,4,2,7,3,0.389804,0.002514,0.001
371830545003028,1,4,1,6,44,0.336979,0.008142,0.002088
371830505002019,1,4,3,8,75,0.34019,0.006198,0.000877
371830516005010,1,4,4,9,12,0.545659,0.004864,0.000518
371830524011049,3,5,5,13,9,2.411451,0,0
371830503001011,1,4,3,8,95,0.146301,0.003783,0.000591
371830505002010,1,4,3,8,42,0.22268,0.005215,0.000579
371830524011056,3,5,5,13,38,2.218806,0,0
371830512003028,1,2,3,6,22,0.255581,0.023205,0.000709
371830518003021,1,4,4,9,14,0.529132,0.004919,0.000462
371830545004010,2,5,5,12,48,1.311258,0,0
371830514004001,1,4,3,8,124,0.578201,0.007505,0.000675
371830545001005,1,2,2,5,2,0.150527,0.025035,0.001346
371830536102010,2,4,4,10,33,0.721885,0.001964,0.000197
371830523022013,2,5,5,12,48,1.312134,0,0
371830537192008,5,5,5,15,69,3.780197,0,0
371830517002015,2,4,4,10,174,0.66171,0.001859,0.000336
371830527073044,3,5,5,13,3,1.943519,0,0
371830537152002,2,3,4,9,18,0.660494,0.012254,0.000211
371830537241030,2,4,4,10,226,1.02128,0.0085,0.000147
371830541102027,5,5,5,15,68,3.693918,0,0
371830538071017,2,4,4,10,256,0.658208,0.010065,0.000201
371830542071037,3,5,5,13,69,1.901052,0,0
371830518001015,1,4,4,9,36,0.106874,0.006237,0.000524
371830545004013,1,4,4,9,137,0.152837,0.00545,0.000141
371830537091000,2,5,5,12,218,1.496366,0,0
371830525032007,2,4,5,11,21,0.845748,0.004523,9.4e-05
371830524093004,1,5,4,10,109,0.061657,0.001195,0.000132
371830526012001,2,4,4,10,23,0.800709,0.004062,0.000127
371830524072000,2,4,4,10,75,1.060578,0.00124,0.000144
371830521013011,2,3,4,9,29,0.911001,0.013469,0.000454
371830540181019,2,4,4,10,166,0.717391,0.007237,0.000104
371830528062017,2,4,4,10,87,1.053208,0.006846,0.000189
371830525043026,2,4,5,11,24,0.731454,0.004523,9.4e-05
371830525033016,2,4,5,11,34,0.793216,0.004523,9.4e-05
371830523021001,1,3,4,8,26,0.492905,0.019148,0.000207
371830517002016,2,4,4,10,67,0.782373,0.003371,0.000396
371830537142023,2,4,4,10,27,0.916602,0.002435,0.000119
371830512003008,1,4,3,8,113,0.136776,0.0067,0.000533
371830540011005,1,4,5,10,72,0.349251,0.002659,6.9e-05
371830537241078,3,5,5,13,83,1.598734,0,0
371830540061003,2,5,4,11,209,0.986708,3.5e-05,0.000128
371830540071012,2,5,5,12,110,1.482063,0,0
371830517002017,1,4,3,8,65,0.548445,0.007749,0.000585
371830541102008,5,5,5,15,9,3.799104,0,0
371830541041012,3,5,5,13,38,1.638029,0,0
371830520012010,2,4,3,9,21,0.844591,0.002643,0.000692
371830540143030,2,4,4,10,88,1.223595,0.003023,0.000139
371830525043007,1,3,3,7,11,0.356571,0.011659,0.000574
371830541103018,5,5,5,15,32,3.443466,0,0
371830524011084,2,4,4,10,16,1.099802,0.00124,0.000144
371830526011031,1,4,4,9,27,0.077032,0.004062,0.000127
371830541102052,4,5,5,14,62,3.253795,0,0
371830537092011,3,5,5,13,78,1.598753,0,0
371830510002007,1,2,2,5,60,0.312084,0.021897,0.001348
371830540141009,3,5,5,13,33,1.742317,0,0
371830520024002,2,4,2,8,197,0.951444,0.00289,0.00103
371830505001017,1,4,2,7,16,0.225457,0.006579,0.001119
371830519002021,1,4,3,8,26,0.623761,0.006361,0.000747
371830521012009,1,4,4,9,94,0.183625,0.010931,0.000513
371830527051002,2,4,4,10,49,0.846686,0.004763,0.000215
371830537252006,2,4,4,10,7,1.279797,0.0085,0.000147
371830503002008,1,3,3,7,2,0.463201,0.021749,0.000952
371830545003009,3,5,5,13,74,1.670247,0,0
371830541041008,3,5,5,13,290,1.762339,0,0
371830545001002,1,2,2,5,38,0.19612,0.024974,0.001287
371830527011013,1,4,4,9,70,0.266855,0.002575,0.000102
371830537223001,1,4,4,9,67,0.249782,0.010065,0.000201
371830507001006,1,4,1,6,61,0.222582,0.00489,0.001646
371830505003012,1,4,4,9,34,0.26999,0.004567,0.000165
371830521013008,2,4,4,10,73,1.215067,0.006613,0.000142
371830540012014,2,4,4,10,58,1.230401,0.002575,0.000102
371830537252044,3,5,5,13,631,1.840549,0,0
371830512002012,1,4,3,8,45,0.091364,0.007471,0.000768
371830514002012,1,4,3,8,77,0.145519,0.006832,0.000633
371830517002006,2,4,3,9,105,0.817582,0.006008,0.000637
371830541103005,5,5,5,15,146,3.768553,0,0
371830525032011,2,4,5,11,69,1.020929,0.004523,9.4e-05
371830540163016,2,5,5,12,135,1.514017,0,0
371830537232017,2,5,4,11,6,0.686314,3.5e-05,0.000258
371830517002002,1,4,4,9,82,0.404075,0.005353,0.000502
371830525033019,2,4,5,11,69,1.221995,0.004523,9.4e-05
371830537241076,3,5,5,13,167,1.56232,0,0
371830537112018,2,3,4,9,138,0.685112,0.012746,0.000229
371830527061023,2,5,5,12,209,1.331303,0,0
371830537093012,3,5,5,13,146,2.152873,0,0
371830518001022,1,4,4,9,43,0.446759,0.004919,0.000462
371830524041007,1,4,4,9,44,0.458982,0.003827,0.000483
371830514004009,2,4,4,10,6,0.653302,0.00294,0.000491
371830537152000,1,3,4,8,188,0.372088,0.012254,0.000211
371830507001001,1,4,1,6,36,0.152178,0.005226,0.001752
371830540071005,2,5,4,11,7,0.883582,3.5e-05,0.000258
371830540141007,3,5,5,13,6,1.818999,0,0
371830510001010,1,3,3,7,84,0.304061,0.021693,0.000648
371830540071014,2,5,4,11,20,1.096742,3.5e-05,0.000128
371830520012022,2,5,5,12,519,1.376925,0,0
371830537112001,2,4,4,10,121,1.092189,0.0085,0.000147
371830521014016,1,3,3,7,22,0.258334,0.013062,0.000645
371830528033055,3,5,5,13,92,1.688746,0,0
371830528072070,2,4,4,10,45,0.781971,0.010303,0.000189
371830501001000,1,4,1,6,62,0.101434,0.006402,0.001653
371830527012035,2,5,5,12,53,1.489126,0,0
371830537093059,4,5,5,14,15,2.50169,0,0
371830537232012,1,5,4,10,42,0.184647,0,0.00013
371830523013032,2,5,5,12,84,1.351786,0,0
371830537142014,2,4,4,10,41,0.670799,0.002435,0.000119
371830540011008,1,3,4,8,27,0.400812,0.016915,0.000407
371830540132001,1,4,4,9,264,0.473596,0.002632,0.000288
371830501001093,1,2,1,4,72,0.018519,0.02383,0.002002
371830518002024,1,4,4,9,52,0.324488,0.004688,0.000458
371830540141034,3,5,5,13,43,1.66263,0,0
371830537161006,1,3,4,8,218,0.44985,0.014256,0.000338
371830507001021,1,4,1,6,42,0.224736,0.010436,0.001831
371830526011010,1,3,4,8,56,0.591244,0.018318,0.000465
371830506003003,1,4,1,6,47,0.193095,0.005143,0.001659
371830527052013,2,4,4,10,57,0.99015,0.002464,0.000129
371830516003012,1,4,3,8,59,0.384819,0.005268,0.000633
371830537093014,3,5,5,13,11,2.024662,0,0
371830516002006,2,4,4,10,53,1.075675,0.00255,0.000131
371830540171037,2,5,5,12,6,1.315204,0,0
371830525043003,1,3,3,7,64,0.536582,0.011659,0.000574
371830528064055,3,5,5,13,109,1.878104,0,0
371830540151022,2,4,4,10,206,0.787156,0.003023,0.000139
371830527062011,3,5,5,13,241,1.797644,0,0
371830540132017,2,4,4,10,132,0.916565,0.002632,0.000288
371830527061019,3,5,5,13,45,1.702828,0,0
371830536101057,2,4,4,10,29,1.101106,0.001964,0.000197
371830542071102,2,4,4,10,121,1.133265,0.002632,0.000288
371830542071113,2,4,4,10,91,1.101177,0.002632,0.000288
371830510002002,1,2,3,6,28,0.357744,0.023792,0.00088
371830527011008,2,4,4,10,54,0.768883,0.002575,0.000102
371830524071016,2,4,4,10,168,0.731386,0.001783,0.000248
371830507002011,1,4,1,6,31,0.045009,0.007709,0.001424
371830540141081,3,5,5,13,150,1.687154,0,0
371830523023013,2,5,5,12,184,1.409322,0,0
371830503001019,1,4,2,7,8,0.370363,0.006042,0.001251
371830501001010,1,4,2,7,2,0.584438,0.004564,0.001357
371830541043031,2,5,5,12,134,1.532018,0,0
371830537112009,2,3,4,9,26,0.890925,0.012746,0.000229
371830527073033,2,5,5,12,153,1.313083,0,0
371830528062002,3,5,5,13,85,1.564083,0,0
371830536101071,1,4,4,9,23,0.437867,0.001964,0.000197
371830537073016,2,3,4,9,354,0.770502,0.016673,0.000368
371830527051009,1,4,4,9,177,0.237501,0.004763,0.000215
371830525041010,2,5,5,12,58,1.347795,0,0
370630019002100,5,5,5,15,71,4.024103,0,0
371830540043002,1,4,4,9,40,0.36319,0.007237,0.000104
371830509002002,1,2,1,4,38,0.183264,0.026608,0.001644
371830540142004,1,4,4,9,239,0.38653,0.001332,0.00017
371830507003021,1,4,2,7,51,0.094146,0.004254,0.001299
371830507002001,1,4,1,6,35,0.149573,0.005514,0.001581
371830540141005,3,5,5,13,123,1.566134,0,0
371830538082014,2,5,5,12,80,1.378822,0,0
371830541061028,3,5,5,13,31,2.316666,0,0
371830525043002,1,3,3,7,3,0.454347,0.011659,0.000574
371830541062021,2,4,4,10,3,0.989675,0.006846,0.000189
371830527051023,2,4,4,10,144,0.753129,0.004763,0.000215
371830517002011,1,4,3,8,99,0.490468,0.00923,0.000863
371830515012007,1,4,3,8,44,0.518661,0.009853,0.000696
371830537132004,1,4,5,10,91,0.447849,0.004246,8.2e-05
371830510002023,1,2,1,4,16,0.155477,0.025135,0.001466
371830521021012,2,5,4,11,50,1.057326,0.000247,0.000338
371830540181013,2,4,4,10,6,1.03922,0.005321,0.000225
371830537262012,2,4,4,10,25,1.231539,0.002435,0.000119
371830536101018,2,5,5,12,50,1.391203,0,0
371830540041000,1,4,4,9,404,0.531778,0.007237,0.000104
371830545001008,1,3,3,7,11,0.342191,0.020215,0.000791
371830530081055,2,1,5,8,8,1.026573,0.033889,7.2e-05
371830524061002,2,1,4,7,41,0.924691,0.035672,0.00032
371830537111010,3,5,5,13,22,1.800217,0,0
371830536101016,2,5,5,12,80,1.478352,0,0
371830540012008,2,4,4,10,221,0.635488,0.005234,0.000171
371830541101003,4,5,5,14,74,2.82065,0,0
371830512003030,1,2,3,6,16,0.142129,0.022962,0.000586
371830537112026,1,4,5,10,18,0.135475,0.004246,8.2e-05
371830541042025,1,1,4,6,126,0.25091,0.03317,0.0002
371830510002012,1,2,2,5,87,0.244852,0.026086,0.001177
371830537224000,1,5,4,10,185,0.568036,0,0.00013
371830528072058,5,5,5,15,14,3.4182,0,0
371830540134023,3,5,5,13,113,1.937766,0,0
371830537121020,1,4,5,10,1,0.503705,0.004246,8.2e-05
371830508001009,1,4,1,6,25,0.135818,0.010426,0.001687
371830514004012,2,4,3,9,28,0.71173,0.007505,0.000675
371830528063010,3,5,5,13,66,1.573792,0,0
371830540123007,1,4,4,9,63,0.568056,0.007237,0.000104
371830537152016,2,3,4,9,55,0.697363,0.012254,0.000211
371830525032005,2,4,5,11,17,0.870768,0.004523,9.4e-05
371830537241055,2,5,5,12,31,1.530527,0,0
371830537222016,2,5,5,12,51,1.296385,0,0
371830528064057,2,5,5,12,5,1.427542,0,0
371830541055003,2,1,4,7,16,0.876946,0.03317,0.0002
371830520012004,2,5,4,11,21,1.20986,0.000779,0.000203
371830537241040,3,5,5,13,47,1.705449,0,0
371830515011031,1,4,3,8,39,0.419345,0.008815,0.000626
371830515011026,1,4,4,9,89,0.541576,0.007136,0.00048
371830518003019,1,4,4,9,68,0.582708,0.004919,0.000462
371830524063012,3,5,5,13,26,2.228991,0,0
371830536102034,1,4,4,9,31,0.244179,0.001964,0.000197
371830506003027,1,4,1,6,4,0.103319,0.005033,0.001592
371830540163018,1,1,4,6,102,0.613218,0.059635,0.000247
371830523021006,1,3,4,8,26,0.289106,0.019329,0.000293
371830538082019,3,5,5,13,21,1.647624,0,0
371830525051006,2,3,4,9,61,1.064485,0.015238,0.00041
371830540043005,2,4,4,10,67,0.867552,0.007237,0.000104
371830545001029,1,3,3,7,81,0.125176,0.019971,0.00067
371830542091081,4,5,5,14,86,3.295361,0,0
371830524041027,1,1,5,7,28,0.105859,0.033889,7.2e-05
371830537241025,3,5,5,13,298,2.095805,0,0
371830540072005,3,5,5,13,4,1.558594,0,0
371830536101044,2,5,5,12,5,1.383164,0,0
371830541053021,4,5,5,14,52,2.682234,0,0
371830540071002,2,5,4,11,109,1.227896,3.5e-05,0.000128
371830540081003,1,4,4,9,43,0.508808,0.003023,0.000139
371830540162005,3,5,5,13,35,1.670782,0,0
371830540081011,1,4,4,9,117,0.29917,0.003023,0.000139
371830537111032,1,4,5,10,2,0.599965,0.004246,8.2e-05
371830537142015,1,4,4,9,89,0.230524,0.002435,0.000119
371830524062010,3,5,5,13,2,1.821879,0,0
371830541131006,4,5,5,14,6,2.642677,0,0
371830526011028,1,4,4,9,52,0.36963,0.004062,0.000127
371830525072028,3,5,5,13,39,1.879482,0,0
371830537262002,2,4,5,11,2,1.240877,0.004246,8.2e-05
371830540011010,1,4,4,9,62,0.571041,0.005553,0.000163
371830524082002,1,5,4,10,60,0.1687,0.001195,0.000132
371830503001012,1,4,3,8,4,0.076222,0.004026,0.000651
371830520022011,1,4,3,8,40,0.435177,0.001467,0.000655
371830536101058,2,4,4,10,402,1.153563,0.001964,0.000197
371830537143014,2,5,4,11,36,0.981854,0.001169,0.000134
371830521011033,2,4,4,10,35,1.18422,0.002514,0.000107
371830524063010,4,5,5,14,38,2.481408,0,0
371830525052009,2,5,5,12,1,1.336842,0,0
371830506003011,1,4,1,6,21,0.094748,0.006261,0.001819
371830505002011,1,4,3,8,20,0.216079,0.005215,0.000579
371830524062011,3,5,5,13,2,1.814443,0,0
371830516005001,2,4,4,10,28,0.711898,0.004688,0.000458
371830540134037,3,5,5,13,30,1.932166,0,0
371830540082001,2,4,4,10,33,0.704122,0.003023,0.000139
371830537071005,2,5,4,11,153,1.08581,0,0.00013
371830530081047,2,5,5,12,41,1.327298,0,0
371830537112010,2,4,5,11,25,0.805431,0.004246,8.2e-05
371830545002022,1,3,1,5,47,0.524898,0.011601,0.002482
371830526021014,2,4,4,10,148,0.714372,0.005234,0.000171
371830525043037,2,4,4,10,13,0.690397,0.007505,0.00024
371830537241033,3,5,5,13,529,1.559649,0,0
371830541054018,1,4,4,9,65,0.585851,0.011337,0.000103
371830540131019,2,1,4,7,25,1.007616,0.076914,0.000488
371830540134045,2,1,4,7,34,1.270111,0.076914,0.000488
371830525051027,1,4,4,9,335,0.135502,0.004153,0.000334
371830538071020,1,4,4,9,42,0.629128,0.010065,0.000201
371830525052010,2,4,4,10,326,1.219951,0.004153,0.000334
371830537262013,2,4,4,10,90,1.179856,0.002435,0.000119
371830526023000,2,4,4,10,655,1.081185,0.002575,0.000102
371830536101052,3,5,5,13,100,1.949863,0,0
371830501001099,1,4,1,6,2,0.001772,0.00571,0.0018
371830530081058,1,1,5,7,26,0.51628,0.033889,7.2e-05
371830540141076,3,5,5,13,187,1.729894,0,0
371830537251010,1,3,4,8,53,0.519871,0.012746,0.000229
371830523011020,1,1,5,7,8,0.399311,0.033889,7.2e-05
371830537132013,2,4,5,11,135,0.887909,0.004246,8.2e-05
371830527073039,3,5,5,13,90,1.793138,0,0
371830508001003,1,4,1,6,154,0.29345,0.007715,0.001437
371830527042005,1,4,5,10,101,0.606116,0.002298,8.6e-05
371830527073007,2,4,4,10,21,0.901592,0.011337,0.000103
371830525043032,1,4,4,9,58,0.162121,0.007505,0.00024
371830514005019,1,4,3,8,36,0.064709,0.00815,0.000695
371830536101009,3,5,5,13,38,2.059726,0,0
371830537151001,1,3,3,7,22,0.4721,0.01546,0.0006
371830524041024,1,1,4,6,10,0.516097,0.036848,0.0004
371830538082022,2,2,3,7,50,1.208456,0.025679,0.000856
371830527063005,3,5,5,13,1,2.324273,0,0
371830541053018,3,5,5,13,103,2.404434,0,0
371830528062016,2,5,5,12,52,1.527717,0,0
371830541043036,3,5,5,13,96,1.62866,0,0
371830523013015,1,1,5,7,465,0.544977,0.033889,7.2e-05
371830540131015,2,4,4,10,2,1.264066,0.002632,0.000288
371830540082008,2,4,4,10,20,0.669601,0.003023,0.000139
371830541043003,2,4,4,10,65,1.200033,0.003023,0.000139
371830526012003,1,4,4,9,51,0.481984,0.004062,0.000127
371830545002088,2,3,4,9,325,0.773805,0.021712,0.000194
371830541102006,4,5,5,14,66,2.843514,0,0
371830541043015,2,4,4,10,103,0.922064,0.003023,0.000139
371830530081043,2,1,5,8,4,0.978874,0.033889,7.2e-05
371830523022015,1,4,4,9,71,0.175162,0.00545,0.000141
371830540081004,1,4,4,9,99,0.449035,0.003023,0.000139
371830540161012,2,1,4,7,83,1.046712,0.059635,0.000247
371830510001017,1,3,3,7,21,0.474811,0.021651,0.000886
371830540181022,2,4,4,10,23,0.860503,0.007237,0.000104
371830540083008,2,5,5,12,160,1.32942,0,0
371830518002023,1,4,4,9,32,0.460468,0.004688,0.000458
371830537171028,4,5,5,14,93,2.641512,0,0
371830526011013,2,3,4,9,57,0.904239,0.015147,0.000204
371830527042004,1,4,5,10,113,0.606446,0.002298,8.6e-05
371830515012018,2,4,3,9,58,0.796937,0.00533,0.000602
371830501001080,1,2,1,4,2,7.3e-05,0.023888,0.001537
371830527061009,2,5,5,12,230,1.436969,0,0
371830523013014,2,1,5,8,27,0.912394,0.033889,7.2e-05
371830520012023,2,4,4,10,56,0.929742,0.006846,0.000189
371830541054006,1,4,4,9,58,0.576415,0.011337,0.000103
371830525062001,1,3,3,7,12,0.593326,0.013421,0.000543
371830537252034,3,5,5,13,160,1.983261,0,0
371830523012000,2,1,4,7,880,0.652843,0.035608,0.000257
371830537093052,3,5,5,13,43,2.424584,0,0
371830545001022,1,3,3,7,185,0.554041,0.019889,0.000608
370630019002074,5,5,5,15,7,4.655843,0,0
371830538071001,2,4,4,10,2,1.178319,0.010065,0.000201
371830527072011,2,4,4,10,43,1.131057,0.011337,0.000103
371830527042003,2,4,5,11,247,0.634959,0.002298,8.6e-05
371830537161001,1,3,4,8,32,0.49144,0.014256,0.000338
371830541041045,2,4,4,10,79,0.883778,0.003023,0.000139
371830542071099,3,5,5,13,272,1.702379,0,0
371830512001002,1,4,3,8,75,0.375945,0.0067,0.000533
371830511012000,1,5,4,10,239,0.085274,0.000849,0.000102
371830527011000,2,4,4,10,86,0.931743,0.005234,0.000171
371830537163005,1,3,4,8,35,0.076932,0.016915,0.000407
371830520012008,2,4,4,10,4,0.935847,0.007093,0.000528
371830540131004,2,4,4,10,6,0.656532,0.002632,0.000288
371830540132045,3,5,5,13,34,1.652336,0,0
371830527011018,1,4,4,9,137,0.004328,0.002575,0.000102
371830526023002,2,4,4,10,51,0.644351,0.002575,0.000102
371830537093015,3,5,5,13,266,2.038077,0,0
371830519003017,2,4,4,10,104,0.655218,0.005034,0.000464
371830525072007,2,4,4,10,373,1.17467,0.002435,0.000119
370630019002082,5,5,5,15,2,4.482937,0,0
371830537261005,1,4,4,9,298,0.381302,0.002435,0.000119
371830523022011,2,5,5,12,132,1.477548,0,0
371830518003014,1,4,4,9,34,0.35384,0.004919,0.000462
371830518003011,1,4,4,9,40,0.439067,0.004919,0.000462
371830537141008,2,4,5,11,49,1.051284,0.004246,8.2e-05
371830541131010,4,5,5,14,490,2.842574,0,0
371830525041001,2,4,5,11,2037,1.18793,0.004523,9.4e-05
371830509002020,1,2,1,4,47,0.179883,0.026469,0.001408
371830540143036,2,5,5,12,40,1.399654,0,0
371830537131010,2,4,4,10,20,0.756073,0.002435,0.000119
371830540131020,2,1,4,7,48,1.015629,0.076914,0.000488
371830524041017,1,1,4,6,51,0.245972,0.036848,0.0004
371830507003001,1,4,3,8,33,0.399606,0.005775,0.000901
371830527073037,3,5,5,13,93,1.88377,0,0
371830541051028,3,5,5,13,123,2.050018,0,0
371830517002010,2,4,3,9,30,0.676405,0.010742,0.000924
371830540171022,2,4,4,10,73,1.273602,0.007237,0.000104
371830542091051,5,5,5,15,142,3.580476,0,0
371830521012010,1,4,4,9,24,0.102684,0.010931,0.000513
371830540143005,2,4,4,10,70,1.092103,0.001332,0.00017
371830516005008,1,4,4,9,3,0.475356,0.004688,0.000458
371830540072008,3,5,5,13,17,1.609321,0,0
371830525033037,2,4,5,11,122,0.927757,0.004523,9.4e-05
371830537113013,2,3,4,9,49,0.765213,0.012746,0.000229
371830541063017,1,3,4,8,30,0.055239,0.016556,0.000185
371830521014019,1,3,3,7,28,0.410332,0.013485,0.000771
371830527012015,2,4,4,10,101,1.198132,0.002575,0.000102
371830524041012,1,1,4,6,33,0.426044,0.036848,0.0004
371830524072011,2,1,4,7,51,1.020912,0.034432,0.000176
371830540122006,1,4,4,9,263,0.464266,0.009896,0.000173
371830541052013,2,5,5,12,12,1.420791,0,0
371830517003021,2,4,3,9,47,0.934893,0.006392,0.000572
371830524081014,1,4,4,9,62,0.52319,0.002044,0.000235
371830540163014,3,5,5,13,3,1.637103,0,0
371830540012007,1,4,4,9,32,0.417681,0.005234,0.000171
371830528062037,3,5,5,13,18,2.356246,0,0
371830524043001,1,1,4,6,105,0.310976,0.036867,0.000452
371830516002021,1,4,4,9,70,0.134761,0.00418,0.000402
371830540134042,2,5,5,12,10,1.421785,0,0
371830528072015,2,4,4,10,32,0.772634,0.010303,0.000189
371830537093058,3,5,5,13,101,2.372592,0,0
371830507003019,1,4,2,7,94,0.247953,0.005188,0.001334
371830541102025,5,5,5,15,115,4.002216,0,0
371830503002017,1,2,2,5,27,0.435092,0.022184,0.001057
371830537073014,2,3,3,8,244,0.850097,0.01695,0.000535
371830519002009,1,4,3,8,56,0.551683,0.00604,0.000543
371830536101048,3,5,5,13,121,1.637041,0,0
371830540163007,2,1,4,7,35,1.273458,0.059635,0.000247
371830505001020,1,4,2,7,38,0.181671,0.006666,0.001297
371830545003017,2,5,5,12,46,1.49813,0,0
371830519002020,1,4,3,8,28,0.532387,0.006812,0.000869
371830537142006,2,5,4,11,164,1.080681,0.001169,0.000134
371830520021012,1,4,4,9,60,0.457049,0.006846,0.000189
371830521021001,2,4,4,10,6,0.709134,0.006846,0.000189
371830540082002,1,4,4,9,189,0.57999,0.003023,0.000139
371830537162004,2,3,4,9,258,1.147476,0.014256,0.000338
371830518001012,1,4,4,9,54,0.274091,0.004919,0.000462
371830506003024,1,4,1,6,106,0.034623,0.005587,0.001794
371830538084018,2,2,3,7,2,0.778447,0.025679,0.000856
371830526021009,2,4,4,10,46,0.930832,0.005234,0.000171
371830510001018,1,3,3,7,65,0.496183,0.021651,0.000886
371830525051019,2,4,4,10,16,0.71764,0.007136,0.00048
371830540131053,3,5,5,13,276,1.638153,0,0
371830521021000,2,4,4,10,43,0.672508,0.006846,0.000189
371830540123004,2,4,4,10,38,0.836841,0.007237,0.000104
371830527043024,2,4,5,11,3,1.149625,0.002298,8.6e-05
371830521011011,2,4,4,10,28,1.209628,0.002514,0.000107
371830537171019,3,5,5,13,37,2.125651,0,0
371830536102112,1,4,4,9,14,0.188111,0.001964,0.000197
371830527012003,2,4,4,10,368,1.236387,0.002575,0.000102
371830541102007,4,5,5,14,50,2.723482,0,0
371830526031013,1,3,3,7,284,0.374979,0.012124,0.000955
371830528062054,3,5,5,13,49,1.634624,0,0
371830536101012,2,5,5,12,42,1.450672,0,0
371830501001071,1,2,1,4,3,0.120068,0.024555,0.001927
371830540141028,3,5,5,13,81,1.560916,0,0
371830519002003,1,4,4,9,167,0.437577,0.005367,0.000445
371830507002000,1,4,1,6,56,0.229737,0.005514,0.001457
371830520011000,3,5,5,13,1014,1.902183,0,0
371830540171036,2,4,4,10,44,1.226013,0.007237,0.000104
371830528033048,3,5,5,13,213,1.805426,0,0
371830523023033,3,5,5,13,80,1.700119,0,0
371830540132050,2,4,4,10,30,1.156616,0.002632,0.000288
371830540111001,3,5,5,13,162,1.724003,0,0
371830526023004,2,4,4,10,65,0.856125,0.002575,0.000102
371830517001007,1,4,4,9,96,0.454028,0.004919,0.000462
371830523013025,2,1,5,8,140,0.910894,0.033889,7.2e-05
371830537231013,1,5,4,10,128,0.430001,0,0.00013
371830527011019,1,4,4,9,32,0.275918,0.002575,0.000102
371830537162006,2,3,4,9,50,0.79442,0.014256,0.000338
371830519001038,1,4,3,8,45,0.261427,0.005769,0.000843
371830506001002,1,4,3,8,646,0.586204,0.006033,0.000665
371830521012004,1,3,3,7,166,0.457702,0.014794,0.000604
371830538082011,2,4,4,10,64,1.185352,0.010065,0.000201
371830517003017,2,4,4,10,46,1.010105,0.008373,0.000528
371830540161001,2,1,4,7,11,0.8237,0.059635,0.000247
371830541061027,3,5,5,13,23,2.414802,0,0
371830506002040,1,4,2,7,2,0.32126,0.007081,0.001165
371830542071093,3,5,5,13,15,1.848081,0,0
371830516005011,1,4,4,9,58,0.551593,0.004688,0.000458
371830537222015,2,4,5,11,15,1.274189,0.004246,8.2e-05
371830540143002,3,5,5,13,76,1.846915,0,0
371830541055007,2,1,4,7,35,1.24887,0.03317,0.0002
371830524063019,3,5,5,13,16,2.179501,0,0
371830509001010,1,2,2,5,87,0.230123,0.025035,0.001346
371830521021007,2,4,4,10,202,0.844211,0.006846,0.000189
371830537211015,3,5,5,13,126,2.088,0,0
371830541102045,5,5,5,15,195,3.382742,0,0
371830540161002,2,1,4,7,180,1.017829,0.059635,0.000247
371830541063008,2,3,4,9,92,0.742563,0.016556,0.000185
371830521014024,1,3,3,7,35,0.557967,0.014794,0.000604
371830524072009,2,4,4,10,157,1.021454,0.00124,0.000144
371830501001049,1,4,1,6,29,0.088422,0.005637,0.001884
371830541042026,1,1,4,6,120,0.358354,0.03317,0.0002
371830545001003,1,2,2,5,73,0.145758,0.025035,0.001346
371830545004018,2,4,4,10,53,0.705495,0.00545,0.000141
371830540162016,2,1,4,7,7,0.716162,0.059635,0.000247
371830527052022,2,4,4,10,46,0.887525,0.002464,0.000129
371830541102004,4,5,5,14,60,2.808414,0,0
371830524063011,4,5,5,14,175,2.664681,0,0
371830520021003,2,4,4,10,19,0.729577,0.006846,0.000189
371830540041005,1,4,4,9,33,0.531899,0.009896,0.000173
371830501001050,1,4,1,6,7,0.032714,0.005587,0.001794
371830541054023,2,5,5,12,5,1.384047,0,0
371830540181031,1,4,5,10,76,0.578839,0.002298,8.6e-05
371830527043005,1,4,5,10,15,0.477678,0.002298,8.6e-05
371830538071022,2,4,4,10,44,0.724475,0.010065,0.000201
371830537181005,5,5,5,15,263,3.974245,0,0
371830523011005,1,1,4,6,32,0.152547,0.035608,0.000257
371830508001010,1,4,1,6,51,0.191081,0.010426,0.001687
371830520024004,2,4,2,8,37,0.789828,0.002916,0.001104
371830541051002,4,5,5,14,58,2.489443,0,0
371830516004017,1,4,3,8,13,0.089263,0.005007,0.000651
371830537072001,1,5,4,10,47,0.291679,3.5e-05,0.000258
371830540061002,2,5,5,12,189,1.416265,0,0
371830506003019,1,4,1,6,35,0.176316,0.00556,0.001704
371830512002017,1,3,3,7,69,0.57339,0.02135,0.000588
371830528033073,2,5,5,12,46,1.438875,0,0
371830509003001,1,2,1,4,34,0.027329,0.026404,0.001666
371830541043016,2,4,4,10,2,0.986757,0.003023,0.000139
371830540013006,1,4,5,10,301,0.564601,0.002659,6.9e-05
371830536102019,2,4,4,10,44,0.794025,0.001964,0.000197
371830510002009,1,2,1,4,7,0.139001,0.025559,0.001523
371830540112002,2,2,3,7,62,0.92899,0.025679,0.000856
371830527011007,1,4,4,9,79,0.621398,0.002575,0.000102
371830537142022,2,4,4,10,2,0.932003,0.002435,0.000119
371830528033064,3,5,5,13,54,1.799317,0,0
371830521012015,1,4,4,9,102,0.327341,0.010931,0.000513
370630019002065,5,5,5,15,48,4.717595,0,0
371830530081021,2,1,5,8,125,1.184017,0.033889,7.2e-05
371830527062009,3,5,5,13,171,1.928085,0,0
371830517001001,1,4,3,8,43,0.189713,0.009511,0.000789
371830540131010,2,4,4,10,71,0.843715,0.002632,0.000288
371830528061020,3,5,5,13,121,1.899336,0,0
371830540141045,2,4,4,10,212,0.715018,0.001332,0.00017
371830540081006,1,4,4,9,67,0.317232,0.003023,0.000139
371830514002011,1,4,3,8,80,0.440358,0.007505,0.000675
371830541062005,2,5,5,12,493,1.468189,0,0
371830537091004,2,5,5,12,73,1.42368,0,0
371830540181016,2,4,5,11,4,0.883797,0.002298,8.6e-05
371830524041015,1,1,4,6,243,0.38077,0.035672,0.00032
371830536101036,2,4,4,10,716,1.147189,0.001964,0.000197
371830537071022,1,3,4,8,104,0.270961,0.012254,0.000211
371830537093013,3,5,5,13,13,2.056647,0,0
371830526011000,2,4,4,10,28,1.230999,0.00583,0.00033
371830541055002,2,1,4,7,195,0.804974,0.03317,0.0002
371830537171036,4,5,5,14,7,3.194867,0,0
371830519001012,1,4,4,9,65,0.542768,0.001473,0.000378
371830537181015,5,5,5,15,49,3.744874,0,0
371830537171023,4,5,5,14,44,2.596476,0,0
371830545004003,1,4,4,9,894,0.44188,0.00545,0.000141
371830541101004,5,5,5,15,583,3.55377,0,0
371830541053007,4,5,5,14,793,2.815793,0,0
371830527063008,3,5,5,13,139,2.132231,0,0
371830541041015,3,5,5,13,4,1.994566,0,0
371830540121013,2,5,5,12,2,1.492465,0,0
371830542102042,5,5,5,15,59,3.727619,0,0
371830541063038,2,3,4,9,31,0.661036,0.016556,0.000185
371830517003022,1,4,4,9,32,0.507781,0.004311,0.000401
371830526012018,1,4,4,9,87,0.275379,0.008373,0.000528
371830528061003,2,4,4,10,18,1.03614,0.010303,0.000189
371830540061005,1,5,4,10,122,0.629813,3.5e-05,0.000128
371830541103022,5,5,5,15,68,4.27885,0,0
371830501001108,1,2,1,4,21,0.18482,0.023208,0.001717
371830537241028,3,5,5,13,107,1.920407,0,0
371830540012002,2,4,4,10,88,1.15772,0.005234,0.000171
371830536102020,2,4,4,10,156,0.692625,0.001964,0.000197
371830526032009,1,3,3,7,53,0.617071,0.012516,0.000853
371830505001030,1,4,1,6,25,0.061206,0.006299,0.001513
371830541131008,5,5,5,15,1,4.261126,0,0
371830537132012,2,4,4,10,189,1.153635,0.006681,0.0002
371830503002009,1,2,3,6,10,0.342068,0.021919,0.000956
371830540162018,2,1,4,7,33,1.128802,0.059635,0.000247
371830536101028,3,5,5,13,42,1.970196,0,0
371830524041002,1,1,4,6,11,0.382681,0.036848,0.0004
371830525052001,1,3,4,8,6,0.613225,0.012254,0.000211
371830541055005,2,1,4,7,58,0.638033,0.03317,0.0002
371830537251005,3,5,5,13,60,1.765826,0,0
371830521012012,1,3,3,7,63,0.282082,0.014794,0.000604
371830519003009,2,4,4,10,50,0.852052,0.00434,0.000289
371830525043024,2,4,5,11,26,0.666108,0.004523,9.4e-05
371830501001008,1,4,1,6,3,0.592475,0.004658,0.001419
371830523022014,1,4,4,9,270,0.353332,0.00545,0.000141
371830524063006,4,5,5,14,74,2.682641,0,0
371830527072025,2,4,4,10,100,1.051714,0.011337,0.000103
371830537181014,5,5,5,15,84,3.644377,0,0
371830537163003,2,3,4,9,58,0.70074,0.016673,0.000368
371830541052032,3,5,5,13,13,1.768169,0,0
371830540151038,1,4,4,9,226,0.450192,0.003023,0.000139
371830509002007,1,2,2,5,163,0.264615,0.022195,0.001303
371830525072024,3,5,5,13,116,2.016222,0,0
371830524093006,1,5,4,10,163,0.277097,0.001195,0.000132
371830518002014,1,4,4,9,88,0.367471,0.006237,0.000524
371830527052038,2,4,4,10,5,1.060896,0.003061,0.000127
371830542102031,5,5,5,15,9,3.525936,0,0
371830505002002,1,4,4,9,200,0.0339,0.004567,0.000165
371830537112002,3,5,5,13,79,1.666555,0,0
371830528033008,3,5,5,13,40,1.960548,0,0
371830509002013,1,2,2,5,26,0.132197,0.022202,0.001361
371830537093005,3,5,5,13,281,2.355598,0,0
371830523011012,2,1,5,8,17,0.992649,0.033889,7.2e-05
371830542071021,4,5,5,14,796,2.589141,0,0
371830540081008,1,4,4,9,72,0.38907,0.003023,0.000139
371830525042001,1,4,4,9,126,0.245492,0.007597,0.000446
371830516004007,1,4,4,9,130,0.442669,0.003789,0.000471
371830528033025,2,5,5,12,83,1.374588,0,0
371830520023006,2,4,4,10,108,0.644441,0.006846,0.000189
371830524011002,4,5,5,14,5,2.616048,0,0
371830509002003,1,2,1,4,42,0.289142,0.026774,0.001714
371830537252016,1,3,4,8,17,0.378225,0.012746,0.000229
371830540042003,2,4,4,10,527,0.753939,0.009896,0.000173
371830518002008,1,4,4,9,109,0.252314,0.004919,0.000462
371830508002004,1,4,2,7,44,0.345904,0.007257,0.00102
371830501001091,1,2,1,4,6,0.01864,0.023437,0.001796
371830542071091,2,5,5,12,170,1.424861,0,0
371830524071012,2,4,4,10,272,1.206594,0.00209,0.000246
371830540111014,2,2,3,7,1,1.188743,0.025679,0.000856
371830537093035,4,5,5,14,26,2.499176,0,0
371830545002010,1,4,1,6,51,0.254801,0.009058,0.002393
371830542091031,5,5,5,15,37,3.789491,0,0
371830516002023,1,4,3,8,53,0.330984,0.004548,0.000541
371830528064008,3,5,5,13,58,1.735436,0,0
371830545003014,2,5,5,12,111,1.482733,0,0
371830514002013,1,4,3,8,25,0.206257,0.006832,0.000633
371830537093002,3,5,5,13,4,2.065481,0,0
371830537092027,2,5,5,12,692,1.386187,0,0
371830541063034,2,3,4,9,110,0.80805,0.016556,0.000185
371830527063016,3,5,5,13,22,1.898161,0,0
371830540141068,2,5,5,12,45,1.385108,0,0
371830537092020,2,4,4,10,79,1.215208,0.002435,0.000119
371830538071007,1,4,4,9,1,0.37113,0.010065,0.000201
371830542071036,4,5,5,14,171,2.611505,0,0
371830537112011,1,3,4,8,3,0.540959,0.012746,0.000229
371830541054014,2,4,4,10,2,1.02867,0.011337,0.000103
371830512003026,1,2,3,6,11,0.177469,0.023205,0.000709
371830528063020,2,5,5,12,13,1.378647,0,0
371830511022001,1,3,4,8,2026,0.407506,0.019997,0.000437
371830536102109,1,4,4,9,28,0.215703,0.001964,0.000197
371830515022026,1,4,4,9,76,0.459353,0.00418,0.000402
371830527011012,1,4,4,9,28,0.169904,0.002575,0.000102
371830540132027,2,4,4,10,52,1.248386,0.002632,0.000288
371830545001023,1,3,3,7,33,0.485074,0.020133,0.000668
371830540072009,2,5,4,11,54,1.163261,0,0.00013
371830540161011,2,1,4,7,37,0.812082,0.059635,0.000247
371830515021004,2,4,4,10,51,0.678754,0.001218,0.00018
371830527052014,2,4,4,10,61,1.028886,0.002464,0.000129
371830537111015,3,5,5,13,60,1.755483,0,0
371830527012002,2,4,5,11,25,1.250216,0.002298,8.6e-05
371830527062005,3,5,5,13,9,1.703987,0,0
371830528071003,4,5,5,14,3,2.73958,0,0
371830527063015,3,5,5,13,10,1.85491,0,0
371830520022013,1,4,3,8,53,0.203055,0.001467,0.000655
371830507003007,1,4,3,8,20,0.441773,0.002452,0.000941
371830512003029,1,2,3,6,33,0.161582,0.023205,0.000709
371830541063026,2,3,4,9,55,0.904834,0.016556,0.000185
371830528072018,2,4,4,10,62,0.681829,0.010303,0.000189
371830537093009,3,5,5,13,54,2.368743,0,0
371830512003031,1,2,3,6,33,0.28456,0.02323,0.000787
371830540061010,2,4,4,10,209,0.971189,0.002694,0.000197
371830540131006,2,4,4,10,5,1.007509,0.002632,0.000288
371830525062006,2,3,3,8,30,0.817164,0.013421,0.000543
371830527072014,1,4,4,9,58,0.197169,0.011337,0.000103
371830516002011,1,4,4,9,73,0.613322,0.00255,0.000131
371830537132019,1,4,5,10,108,0.486171,0.004246,8.2e-05
371830541131007,4,5,5,14,35,3.174644,0,0
371830540171033,2,4,4,10,460,1.202428,0.007237,0.000104
371830537261014,2,4,4,10,67,0.649151,0.002435,0.000119
371830541061037,3,5,5,13,100,1.658756,0,0
371830540081007,1,4,4,9,29,0.404874,0.003023,0.000139
371830537112014,2,3,4,9,47,0.635213,0.012746,0.000229
371830523023006,2,5,5,12,61,1.438833,0,0
371830536101079,3,5,5,13,134,2.137684,0,0
371830540082011,2,4,4,10,38,0.846416,0.003023,0.000139
371830527073014,2,4,4,10,136,1.111788,0.011337,0.000103
371830542071104,2,4,4,10,83,1.056313,0.002632,0.000288
371830505002013,1,4,3,8,8,0.477714,0.005561,0.000752
371830526032000,1,4,3,8,19,0.572406,0.008856,0.000655
371830540163004,2,1,4,7,45,0.828725,0.059635,0.000247
371830514003010,1,4,3,8,76,0.588753,0.007505,0.000675
371830515011015,1,4,4,9,20,0.243345,0.007136,0.00048
371830527052021,1,4,4,9,49,0.538998,0.002464,0.000129
371830528033015,3,5,5,13,44,1.75673,0,0
371830504002006,1,4,2,7,105,0.197323,0.004321,0.001199
371830526031001,2,4,4,10,85,0.7195,0.008373,0.000528
371830506002005,1,4,2,7,18,0.240013,0.006626,0.00099
371830526021007,2,4,4,10,219,0.698497,0.00583,0.00033
371830537092028,2,5,5,12,1,1.30328,0,0
371830537113018,2,4,4,10,23,0.683116,0.006681,0.0002
371830521014029,1,3,4,8,71,0.276367,0.01228,0.000497
371830512002000,1,4,3,8,429,0.378018,0.0067,0.000533
371830541042015,1,1,4,6,31,0.294851,0.03317,0.0002
371830512003011,1,4,3,8,51,0.12304,0.0067,0.000533
371830525061019,2,4,3,9,17,0.759301,0.011078,0.00063
371830518003010,1,4,4,9,83,0.209567,0.004919,0.000462
371830527073011,2,4,4,10,44,0.638567,0.011337,0.000103
371830514003001,1,4,3,8,46,0.337029,0.005624,0.000621
371830523023027,2,4,4,10,259,0.709669,0.00545,0.000141
371830527073008,2,4,4,10,53,1.128775,0.011337,0.000103
371830507003044,1,4,3,8,26,0.355183,0.008572,0.000818
371830537092018,2,4,4,10,25,1.256027,0.002435,0.000119
371830542071095,3,5,5,13,54,1.98256,0,0
371830540062000,2,4,5,11,115,1.275793,0.002659,6.9e-05
371830525032002,2,4,5,11,1308,0.874409,0.004523,9.4e-05
371830541042008,1,1,4,6,123,0.610284,0.03317,0.0002
371830541043011,3,5,5,13,58,1.888266,0,0
371830540131000,2,5,5,12,568,1.294067,0,0
371830537223003,2,4,4,10,169,0.961985,0.010065,0.000201
371830527071006,2,4,4,10,39,1.214701,0.011337,0.000103
371830545001014,1,3,3,7,53,0.305403,0.020215,0.000854
371830541051003,4,5,5,14,48,2.447013,0,0
371830528064033,3,5,5,13,59,1.838559,0,0
371830524061003,3,5,5,13,648,1.575015,0,0
371830537261001,2,4,4,10,409,0.836061,0.002435,0.000119
371830528061010,1,4,4,9,21,0.310963,0.010303,0.000189
371830537152005,2,5,4,11,244,0.981723,0.001169,0.000134
371830540121005,3,5,5,13,197,1.782682,0,0
371830525072015,2,5,5,12,62,1.399262,0,0
371830517001009,1,4,4,9,67,0.23787,0.004758,0.000362
371830527072012,2,4,4,10,78,0.825867,0.011337,0.000103
371830526012014,2,4,4,10,38,0.755281,0.008373,0.000528
371830537222014,2,5,5,12,52,1.309635,0,0
371830540141057,2,5,5,12,24,1.520492,0,0
371830520024003,2,4,2,8,31,0.948008,0.00289,0.00103
371830530082005,3,5,5,13,247,2.000726,0,0
371830530091000,3,5,5,13,38,2.004388,0,0
371830541061007,3,5,5,13,156,2.380324,0,0
371830540162019,1,1,4,6,208,0.212552,0.059635,0.000247
371830535211002,5,5,5,15,123,3.352294,0,0
371830540121008,2,5,5,12,441,1.464219,0,0
371830526011025,1,4,4,9,60,0.307982,0.004062,0.000127
371830525043035,1,4,4,9,49,0.190244,0.007597,0.000446
371830525031003,3,5,5,13,97,1.756975,0,0
371830516005003,1,4,4,9,42,0.624248,0.004266,0.000456
371830525052008,2,4,4,10,17,1.133303,0.004153,0.000334
371830540141031,2,4,4,10,120,0.969869,0.001332,0.00017
371830537142025,1,3,3,7,4,0.577457,0.013421,0.000543
371830537262001,3,5,5,13,23,1.550087,0,0
371830541053000,3,5,5,13,119,2.09137,0,0
371830540134044,2,5,5,12,52,1.353773,0,0
371830525033009,3,5,5,13,2,2.038958,0,0
371830536101041,2,5,5,12,39,1.344025,0,0
371830537261004,1,4,4,9,4,0.501469,0.002435,0.000119
371830537072000,1,5,4,10,331,0.385055,3.5e-05,0.000258
371830542071109,2,5,5,12,82,1.466141,0,0
371830525051026,1,4,4,9,13,0.178018,0.004062,0.000127
371830508002011,1,3,3,7,153,0.155642,0.012494,0.000717
371830517002001,1,4,4,9,83,0.387591,0.005353,0.000502
371830524063000,3,5,5,13,2,2.374443,0,0
371830540132036,2,5,5,12,113,1.467342,0,0
371830528072064,2,4,4,10,19,1.113221,0.010303,0.000189
371830541052003,2,4,4,10,1,1.249701,0.011337,0.000103
371830514004010,2,4,3,9,43,0.840528,0.003018,0.000546
371830538082009,2,5,5,12,303,1.47535,0,0
371830520012025,2,4,2,8,38,0.810078,0.00289,0.00103
371830537071029,2,5,4,11,67,0.80627,0.001169,0.000134
371830523011015,2,1,5,8,115,0.868165,0.033889,7.2e-05
371830520012003,2,5,5,12,16,1.348993,0,0
371830519003000,1,4,4,9,337,0.076105,0.005013,0.000387
371830506002019,1,4,2,7,36,0.238158,0.007091,0.001245
371830521014033,1,3,3,7,156,0.605018,0.014794,0.000604
371830525041002,2,4,4,10,70,1.082939,0.004201,0.000326
371830526011016,2,4,4,10,45,0.704722,0.004062,0.000127
371830528033023,3,5,5,13,25,1.545795,0,0
371830540072004,3,5,5,13,11,1.53445,0,0
371830525032018,2,4,5,11,74,0.748246,0.004523,9.4e-05
371830519002022,1,4,3,8,57,0.483406,0.006812,0.000869
371830541102028,5,5,5,15,177,3.675374,0,0
371830528064028,1,4,4,9,143,0.520798,0.010303,0.000189
371830519002017,2,4,3,9,46,0.641896,0.00611,0.000614
371830537241034,2,4,4,10,27,1.271885,0.0085,0.000147
371830525072014,3,5,5,13,62,1.623476,0,0
371830540151009,1,4,4,9,180,0.446587,0.003023,0.000139
371830541062038,1,3,4,8,42,0.431945,0.016556,0.000185
371830530082008,2,1,5,8,32,1.210546,0.033889,7.2e-05
371830506003005,1,4,1,6,29,0.105792,0.00561,0.001793
371830525061000,2,3,3,8,138,0.778715,0.013421,0.000543
371830540151030,2,4,4,10,61,1.126578,0.003023,0.000139
371830540134004,3,5,5,13,122,1.85501,0,0
371830540111005,2,5,5,12,264,1.326626,0,0
371830536101093,3,5,5,13,2,1.725109,0,0
371830530081053,3,5,5,13,1,1.734453,0,0
371830523023000,1,4,4,9,39,0.568513,0.00545,0.000141
371830528072021,1,4,4,9,27,0.588791,0.010303,0.000189
371830527072020,2,4,4,10,21,0.950938,0.011337,0.000103
371830537192004,5,5,5,15,355,4.332903,0,0
371830541042001,2,1,4,7,104,1.218075,0.03317,0.0002
371830541132037,3,5,5,13,224,2.297871,0,0
371830540062005,1,3,4,8,74,0.465085,0.016673,0.000368
371830527073004,2,5,5,12,11,1.410256,0,0
371830521011013,2,4,4,10,22,1.104266,0.007092,0.000256
371830523011011,1,1,5,7,461,0.519237,0.033889,7.2e-05
371830536101072,2,5,5,12,53,1.303084,0,0
371830541052002,2,5,5,12,133,1.499428,0,0
371830527071004,2,4,4,10,26,0.849988,0.011337,0.000103
371830526021000,2,4,4,10,13,0.792224,0.005234,0.000171
371830520023004,1,4,4,9,15,0.438145,0.006846,0.000189
371830540142000,1,4,4,9,501,0.41957,0.001332,0.00017
371830524011045,4,5,5,14,21,2.688281,0,0
371830517002005,2,4,4,10,24,0.899045,0.005353,0.000502
371830540121011,1,4,4,9,28,0.618728,0.007237,0.000104
371830530082004,2,5,5,12,22,1.299017,0,0
371830524081000,1,4,4,9,37,0.410771,0.002044,0.000235
371830540151011,1,4,4,9,101,0.134697,0.003023,0.000139
371830540121010,3,5,5,13,66,1.586923,0,0
371830523023011,2,5,5,12,4,1.515803,0,0
371830523023018,2,4,4,10,116,1.25997,0.00545,0.000141
371830527073017,2,4,4,10,38,0.668098,0.011337,0.000103
371830537113001,1,3,4,8,29,0.450386,0.012746,0.000229
371830541054016,2,4,4,10,71,0.823375,0.011337,0.000103
371830541042009,2,1,4,7,264,1.28862,0.03317,0.0002
371830527011009,1,4,4,9,52,0.446566,0.002575,0.000102
371830520021000,1,4,4,9,155,0.441371,0.006846,0.000189
371830540132006,1,4,4,9,2,0.076203,0.002632,0.000288
371830541131001,4,5,5,14,46,2.642206,0,0
371830515011011,1,4,4,9,79,0.229165,0.007136,0.00048
371830541063013,2,5,5,12,8,1.307362,0,0
371830540141032,2,5,5,12,93,1.512015,0,0
371830523023024,2,4,4,10,16,1.217843,0.00545,0.000141
371830527042000,1,4,5,10,584,0.361413,0.002298,8.6e-05
371830540141040,2,5,5,12,79,1.357394,0,0
371830537072007,1,3,4,8,29,0.603014,0.012254,0.000341
371830523022001,1,3,4,8,736,0.495741,0.021712,0.000194
371830541044002,2,5,5,12,25,1.374674,0,0
371830527072013,1,4,4,9,320,0.502918,0.011337,0.000103
371830521021046,2,4,4,10,3,1.03463,0.006846,0.000189
371830506003006,1,4,1,6,33,0.174504,0.00561,0.001793
371830540151031,1,4,4,9,79,0.523715,0.003023,0.000139
371830528062031,3,5,5,13,233,1.995432,0,0
371830501001090,1,2,1,4,152,0.074624,0.023923,0.001822
371830528062042,3,5,5,13,1,1.977358,0,0
371830541061046,2,3,4,9,90,0.996545,0.016556,0.000185
371830527013011,1,4,4,9,20,0.37511,0.004103,0.000228
371830514005008,1,4,3,8,50,0.225193,0.006832,0.000633
371830521021026,1,4,4,9,155,0.507319,0.004318,0.000372
371830541062051,1,3,4,8,22,0.449632,0.016556,0.000185
371830525032026,1,4,4,9,21,0.469432,0.007505,0.00024
371830541061030,3,5,5,13,45,2.281768,0,0
371830526032010,2,3,3,8,39,0.834056,0.012124,0.000955
371830524062008,3,5,5,13,884,2.33752,0,0
371830508001012,1,2,1,4,40,0.050446,0.026698,0.001884
371830526021012,2,4,4,10,50,1.046872,0.005553,0.000163
371830530081054,3,5,5,13,4,1.552271,0,0
371830537131008,1,4,5,10,41,0.118697,0.004246,8.2e-05
371830527012005,2,4,4,10,5,1.119299,0.002575,0.000102
371830537131015,2,4,4,10,15,0.668715,0.002435,0.000119
371830505003010,1,4,4,9,30,0.24596,0.004903,0.000271
371830541102034,4,5,5,14,19,3.12012,0,0
371830537093047,4,5,5,14,102,2.711952,0,0
371830542091046,5,5,5,15,105,3.702584,0,0
371830517003010,1,4,4,9,27,0.590301,0.004311,0.000401
371830528033047,3,5,5,13,84,1.892329,0,0
371830525031012,2,5,5,12,218,1.481794,0,0
371830503002000,1,4,2,7,2,0.329729,0.006067,0.001329
371830508001000,1,4,2,7,58,0.171517,0.007472,0.001377
371830524081015,1,4,4,9,51,0.513908,0.002587,0.000339
371830528033016,3,5,5,13,110,1.7799,0,0
371830527041010,1,4,4,9,152,0.239641,0.004763,0.000215
371830508003002,1,4,2,7,10,0.274411,0.00849,0.001327
371830541062041,2,3,4,9,82,0.711847,0.016556,0.000185
371830516003003,1,4,3,8,87,0.428488,0.005268,0.000633
371830527062002,2,5,5,12,229,1.518548,0,0
371830512003025,1,2,3,6,19,0.215366,0.023205,0.000709
371830530081002,3,5,5,13,58,1.771495,0,0
371830537112023,1,4,5,10,4,0.09617,0.004246,8.2e-05
371830507003005,1,4,3,8,44,0.457954,0.002214,0.000815
371830501001002,1,4,1,6,55,0.131199,0.006578,0.001713
371830537112005,3,5,5,13,58,1.712573,0,0
371830521021044,1,4,4,9,33,0.54449,0.006846,0.000189
371830537111007,3,5,5,13,398,1.948142,0,0
371830524071019,1,1,4,6,428,0.479519,0.036848,0.0004
370630019002076,5,5,5,15,13,5.093099,0,0
371830523013016,1,1,5,7,161,0.33262,0.033889,7.2e-05
371830521011020,1,4,4,9,36,0.285398,0.009606,0.000363
371830540132009,3,5,5,13,178,1.659968,0,0
371830537252003,2,4,4,10,5,1.207832,0.0085,0.000147
371830520022001,2,4,3,9,241,0.769353,0.001939,0.000791
371830501001020,1,4,1,6,22,0.246635,0.00561,0.001793
371830541101006,5,5,5,15,81,3.568929,0,0
371830515012036,1,5,5,11,57,0.521479,0.001038,7e-05
371830536102026,2,4,4,10,32,0.668793,0.001964,0.000197
371830526011018,2,4,4,10,16,0.678383,0.004062,0.000127
371830540131041,2,1,4,7,353,1.273192,0.076914,0.000488
371830527073012,1,4,4,9,75,0.581557,0.011337,0.000103
371830524071026,1,1,4,6,66,0.181947,0.036848,0.0004
371830526032011,2,4,3,9,100,0.658202,0.008856,0.000655
371830517001016,1,4,4,9,15,0.056176,0.004919,0.000462
371830541102023,5,5,5,15,9,3.536102,0,0
371830536101045,3,5,5,13,327,1.806747,0,0
371830528063015,3,5,5,13,55,1.943094,0,0
371830525032013,2,4,5,11,51,1.10517,0.004523,9.4e-05
371830536101014,2,5,5,12,39,1.302298,0,0
371830524063013,3,5,5,13,921,2.26768,0,0
371830537251027,2,3,4,9,51,0.81746,0.012746,0.000229
371830524041000,1,1,4,6,79,0.513849,0.037697,0.000502
371830541102017,5,5,5,15,27,3.887347,0,0
371830537121011,1,4,5,10,2,0.121516,0.004246,8.2e-05
371830526012022,1,4,4,9,28,0.265529,0.004062,0.000127
371830509002006,1,2,2,5,218,0.224935,0.022195,0.001303
371830523022002,2,4,4,10,120,0.669025,0.00545,0.000141
371830530031077,3,5,5,13,12,1.618042,0,0
371830512002008,1,4,3,8,53,0.096416,0.007481,0.000848
371830537092021,2,5,5,12,364,1.329577,0,0
371830540071008,2,5,4,11,104,1.049174,3.5e-05,0.000128
371830509002015,1,2,1,4,4,0.1463,0.026774,0.001651
371830507002009,1,4,1,6,39,0.119082,0.008382,0.001521
371830524093002,1,5,4,10,11,0.103811,0.001195,0.000132
371830505001012,1,4,2,7,6,0.30921,0.005865,0.000968
371830514005003,1,4,3,8,28,0.099196,0.005134,0.000592
371830540163006,2,1,4,7,83,1.095831,0.059635,0.000247
371830526012000,2,4,4,10,46,0.753645,0.007723,0.000326
371830520021018,1,4,4,9,40,0.269391,0.006846,0.000189
371830527051011,1,4,4,9,36,0.398545,0.004763,0.000215
371830540112004,2,2,3,7,239,1.098179,0.025679,0.000856
371830514002001,1,4,3,8,107,0.507654,0.006656,0.000573
371830523012001,1,1,4,6,570,0.092418,0.034432,0.000176
371830540132013,2,5,5,12,96,1.431134,0,0
371830520024012,2,4,2,8,58,0.722799,0.002916,0.001104
371830520024000,2,4,3,9,283,0.809012,0.002188,0.000904
371830537111028,3,5,5,13,36,1.6485,0,0
371830518003013,1,4,4,9,143,0.345841,0.004919,0.000462
371830517003025,2,4,4,10,33,1.074692,0.001689,0.000273
371830540011001,2,4,4,10,37,0.639984,0.005553,0.000163
371830521011021,2,4,4,10,579,0.763947,0.002993,0.000222
371830530081051,3,5,5,13,323,1.686065,0,0
371830537222017,2,5,4,11,16,1.127054,0.001169,0.000264
371830541102005,5,5,5,15,69,3.725248,0,0
371830525032021,2,4,5,11,159,0.642413,0.004523,9.4e-05
371830537191011,5,5,5,15,15,4.105994,0,0
371830541042024,1,1,4,6,354,0.212091,0.03317,0.0002
371830537093016,3,5,5,13,243,2.044475,0,0
371830515011028,2,4,3,9,193,0.684104,0.004292,0.000532
371830501001023,1,4,1,6,2,0.338032,0.006557,0.001636
371830541053017,3,5,5,13,141,2.359014,0,0
371830537151009,1,3,4,8,113,0.432484,0.012254,0.000211
371830541103040,3,5,5,13,126,2.273954,0,0
371830524082008,1,5,4,10,55,0.071352,0.001195,0.000132
371830540151033,2,4,4,10,37,0.633984,0.003023,0.000139
371830537092032,3,5,5,13,34,1.58913,0,0
371830524061000,2,5,5,12,132,1.368524,0,0
371830512003005,1,4,3,8,63,0.110629,0.00815,0.000695
371830537073006,1,3,3,7,27,0.626111,0.01546,0.0006
371830540151015,2,4,4,10,519,0.795525,0.003023,0.000139
371830537252047,3,5,5,13,47,1.589487,0,0
371830521011009,2,4,4,10,112,1.234365,0.006613,0.000142
371830537252037,3,5,5,13,38,1.811562,0,0
371830507002010,1,4,1,6,73,0.306321,0.005503,0.001437
371830514003003,1,4,3,8,63,0.480696,0.004665,0.000633
371830537092029,5,5,5,15,6,3.963594,0,0
371830542071046,4,5,5,14,35,3.01856,0,0
371830520022014,1,4,3,8,102,0.556615,0.001302,0.000586
371830521021005,2,4,4,10,120,1.048669,0.006846,0.000189
371830540072016,2,5,5,12,116,1.35994,0,0
371830515011014,1,4,4,9,44,0.137694,0.007136,0.00048
371830515012020,1,4,4,9,94,0.621814,0.005239,0.000396
371830519003006,1,4,4,9,60,0.254015,0.005034,0.000464
371830542071059,4,5,5,14,39,3.261586,0,0
371830527052010,1,4,4,9,545,0.270714,0.002464,0.000129
371830526011022,1,4,4,9,40,0.424153,0.004062,0.000127
371830527042001,1,4,5,10,508,0.194777,0.002298,8.6e-05
371830537152015,2,3,4,9,11,0.730075,0.012254,0.000211
371830528062030,3,5,5,13,140,1.997257,0,0
371830516005002,2,4,3,9,83,0.769141,0.004843,0.000536
371830540071007,2,5,4,11,41,1.16678,3.5e-05,0.000128
371830528072063,2,4,4,10,18,1.073172,0.010303,0.000189
371830525033015,2,4,5,11,206,1.179659,0.004523,9.4e-05
371830537142007,2,4,4,10,56,1.234052,0.002435,0.000119
371830530081000,3,5,5,13,19,1.883242,0,0
371830537092013,3,5,5,13,82,1.630998,0,0
371830540121003,2,4,4,10,82,0.939757,0.007237,0.000104
371830520021011,2,4,4,10,219,0.707623,0.006846,0.000189
371830516003013,1,4,4,9,97,0.594534,0.003399,0.000415
371830526011008,2,3,4,9,56,0.896651,0.015424,0.000371
371830537241035,2,4,4,10,2,1.188338,0.0085,0.000147
371830527012027,2,4,4,10,1,1.283926,0.002464,0.000129
371830507003010,1,4,2,7,37,0.213684,0.008272,0.001262
371830505001002,1,4,2,7,12,0.289145,0.006368,0.001067
371830537191008,5,5,5,15,60,4.729456,0,0
371830516005006,1,4,4,9,50,0.542297,0.004688,0.000458
371830540141085,3,5,5,13,152,1.793385,0,0
371830537141002,2,4,5,11,617,1.285225,0.004246,8.2e-05
371830537093033,4,5,5,14,25,2.52274,0,0
371830540121004,2,4,4,10,4,0.700452,0.007237,0.000104
371830537221003,2,4,4,10,249,1.150625,0.010065,0.000201
371830542081116,3,5,5,13,33,1.545832,0,0
371830509002022,1,2,1,4,19,0.184001,0.026469,0.001408
371830540182002,3,5,5,13,1185,1.644556,0,0
371830525042003,1,4,4,9,14,0.219033,0.007597,0.000446
371830518002006,1,4,4,9,46,0.096009,0.004919,0.000462
371830514001005,1,4,3,8,20,0.145406,0.005007,0.000651
371830520022005,1,4,3,8,69,0.067027,0.001939,0.000791
371830520012007,2,4,4,10,228,0.963009,0.001915,0.000492
371830526012006,1,4,4,9,27,0.504113,0.004062,0.000127
371830540134036,3,5,5,13,21,1.883632,0,0
371830528072057,5,5,5,15,50,3.390508,0,0
371830540134046,2,1,4,7,2,1.195701,0.076914,0.000488
371830505003004,1,4,4,9,47,0.400124,0.004567,0.000165
371830537092009,3,5,5,13,101,1.578815,0,0
371830537231011,2,5,4,11,269,0.90174,0,0.00013
371830542091055,4,5,5,14,3,3.313522,0,0
371830528064054,3,5,5,13,76,1.778887,0,0
371830525043033,1,4,4,9,84,0.415671,0.007505,0.00024
371830540141094,2,4,4,10,55,0.695219,0.001332,0.00017
371830537121000,3,5,5,13,567,1.900619,0,0
371830526012004,1,4,4,9,48,0.595548,0.007723,0.000326
371830527041013,2,4,4,10,560,0.812336,0.004763,0.000215
371830537072003,1,5,4,10,64,0.459872,0.001204,0.000392
371830527071012,2,3,4,9,91,1.101335,0.013635,0.000189
371830536102002,3,5,5,13,55,2.133507,0,0
371830519003002,1,4,4,9,44,0.089024,0.005013,0.000387
371830540012003,1,4,4,9,51,0.615969,0.009896,0.000173
371830537251026,2,3,4,9,80,0.992193,0.012746,0.000229
371830524091001,1,5,4,10,692,0.310042,0.001195,0.000132
371830537111037,1,4,5,10,5,0.216428,0.004246,8.2e-05
371830541052010,3,5,5,13,106,1.905745,0,0
371830528064027,2,4,4,10,33,0.952952,0.010303,0.000189
371830537191002,5,5,5,15,342,3.926814,0,0
371830512002014,1,3,3,7,63,0.446715,0.021381,0.000765
371830515022015,1,4,4,9,37,0.357969,0.00418,0.000402
371830503002012,1,2,2,5,4,0.563693,0.022447,0.001188
371830537071026,1,3,4,8,46,0.445682,0.012254,0.000211
371830537113009,1,3,4,8,19,0.515997,0.012746,0.000229
371830541102031,5,5,5,15,33,4.038119,0,0
371830540131016,2,5,5,12,75,1.39039,0,0
371830540081015,1,4,4,9,34,0.32278,0.003023,0.000139
371830537151013,1,3,4,8,78,0.329802,0.012254,0.000211
371830542071061,3,5,5,13,82,2.416472,0,0
371830536101031,3,5,5,13,59,1.801206,0,0
371830523023030,1,4,4,9,6,0.601935,0.00545,0.000141
371830518003005,2,4,4,10,148,0.84568,0.004758,0.000362
371830505001010,1,4,2,7,25,0.194828,0.006289,0.001025
371830537171015,4,5,5,14,93,2.871446,0,0
371830540131008,2,5,5,12,4,1.373163,0,0
370630019002068,5,5,5,15,56,4.553118,0,0
371830524011034,4,5,5,14,2,2.679322,0,0
371830537252002,2,5,5,12,42,1.384693,0,0
371830518002007,1,4,4,9,46,0.222108,0.004919,0.000462
371830523023005,2,5,5,12,1336,1.363277,0,0
371830545004011,1,4,4,9,55,0.481657,0.00545,0.000141
371830525043010,1,4,4,9,2,0.343123,0.007597,0.000446
371830530081039,2,1,5,8,46,1.134683,0.033889,7.2e-05
371830517003020,1,4,4,9,71,0.552316,0.004311,0.000401
371830527071002,2,4,5,11,350,0.986161,0.002298,8.6e-05
371830524063009,4,5,5,14,804,2.648926,0,0
371830524072012,2,1,4,7,224,0.749371,0.035672,0.00032
371830541041043,2,4,4,10,4,1.136876,0.003023,0.000139
371830537073011,1,4,4,9,55,0.363913,0.011397,0.000372
371830528072020,1,4,4,9,11,0.575287,0.010303,0.000189
371830537122015,2,4,5,11,125,0.90472,0.004246,8.2e-05
371830540171048,2,1,4,7,7,0.929975,0.059635,0.000247
371830523023032,2,5,5,12,3,1.489743,0,0
371830537241053,2,5,5,12,64,1.521984,0,0
371830526021024,2,4,4,10,81,0.834498,0.005234,0.000171
371830508003001,1,4,1,6,21,0.247997,0.008511,0.001465
371830528064021,1,4,4,9,63,0.543971,0.010303,0.000189
371830540041009,2,4,4,10,246,0.792278,0.009896,0.000173
371830512002010,1,4,3,8,38,0.206385,0.007506,0.000926
371830526021001,2,4,4,10,71,0.850783,0.005234,0.000171
371830540141084,3,5,5,13,23,1.650737,0,0
371830527073022,2,5,5,12,3,1.395683,0,0
371830541054020,1,4,4,9,49,0.384712,0.011337,0.000103
371830536101076,3,5,5,13,88,1.798604,0,0
371830537241079,3,5,5,13,19,1.590025,0,0
371830528064012,3,5,5,13,36,1.595236,0,0
371830540132003,1,4,4,9,5,0.420617,0.002632,0.000288
371830524043007,1,1,4,6,67,0.599614,0.035627,0.000309
371830527043007,1,4,4,9,62,0.277025,0.004763,0.000215
371830537152007,2,3,4,9,8,1.053242,0.01352,0.000195
371830537071016,2,5,4,11,20,1.266185,0.001169,0.000134
371830528064024,1,4,4,9,63,0.483669,0.010303,0.000189
371830537132008,2,4,5,11,77,0.648732,0.004246,8.2e-05
371830508003007,1,4,2,7,55,0.2047,0.00849,0.001388
371830537112015,2,3,4,9,33,0.805635,0.012746,0.000229
371830507003036,1,4,2,7,20,0.287778,0.008484,0.001375
371830527043013,1,4,4,9,115,0.007659,0.004763,0.000215
371830528064047,3,5,5,13,148,1.790409,0,0
371830524081006,1,4,4,9,30,0.408509,0.003827,0.000483
371830537181002,5,5,5,15,110,4.228968,0,0
371830542091080,4,5,5,14,59,3.180986,0,0
371830541051030,3,5,5,13,23,1.717319,0,0
371830541043008,3,5,5,13,220,1.614887,0,0
371830527071011,2,4,4,10,90,0.881696,0.011337,0.000103
371830537252005,2,3,4,9,4,0.771521,0.012746,0.000229
371830528062018,2,4,4,10,6,1.060475,0.006846,0.000189
371830521021030,1,4,4,9,485,0.576107,0.004318,0.000372
371830521021038,1,4,4,9,49,0.334027,0.004318,0.000372
371830514005016,1,4,3,8,39,0.168546,0.00815,0.000695
371830537191000,5,5,5,15,219,4.377662,0,0
371830526012020,1,4,3,8,25,0.265448,0.007814,0.000532
371830540161009,2,1,4,7,40,0.699373,0.059635,0.000247
371830515022000,1,4,4,9,63,0.190761,0.002668,0.000341
371830524063004,4,5,5,14,16,2.524249,0,0
371830525033008,3,5,5,13,2,1.862362,0,0
371830503001024,1,4,3,8,83,0.033526,0.007399,0.000888
371830540134032,3,5,5,13,33,1.839107,0,0
371830521022005,1,4,4,9,69,0.469805,0.004318,0.000372
371830519003004,1,4,4,9,71,0.327025,0.005013,0.000387
371830537113010,1,3,4,8,72,0.335301,0.012746,0.000229
371830541042005,2,1,4,7,105,0.709555,0.03317,0.0002
371830541102029,5,5,5,15,90,4.037986,0,0
371830536102110,1,4,4,9,26,0.255564,0.001964,0.000197
371830540012004,1,4,5,10,215,0.346375,0.002659,6.9e-05
371830515012009,1,4,3,8,15,0.381207,0.008815,0.000626
371830541053014,4,5,5,14,141,2.525123,0,0
371830521014006,2,3,3,8,167,0.712203,0.014794,0.000604
371830537241077,2,5,5,12,78,1.520375,0,0
371830527072019,2,4,4,10,127,1.230386,0.011337,0.000103
371830541062044,2,3,4,9,27,1.041956,0.016556,0.000185
371830530081042,2,5,5,12,175,1.448691,0,0
371830524011069,2,4,4,10,22,1.256786,0.00124,0.000144
371830545004006,2,5,5,12,3,1.306069,0,0
371830528072067,1,4,4,9,52,0.591057,0.010303,0.000189
371830506002033,1,4,1,6,9,0.118186,0.009411,0.001773
371830541051034,3,5,5,13,39,1.753879,0,0
371830507001007,1,4,1,6,49,0.170849,0.007747,0.001657
371830537091009,3,5,5,13,36,1.995967,0,0
371830545001020,1,3,3,7,14,0.206491,0.020215,0.000791
371830541102041,4,5,5,14,22,2.832011,0,0
371830537093001,3,5,5,13,1,2.356487,0,0
371830508002008,1,4,2,7,143,0.238244,0.009379,0.001166
371830510002021,1,2,2,5,38,0.145654,0.024164,0.001052
371830537132018,1,4,5,10,91,0.375293,0.004246,8.2e-05
371830537091003,3,5,5,13,73,1.600818,0,0
371830525062002,2,3,3,8,28,0.639306,0.013421,0.000543
371830537141015,2,5,4,11,136,1.123869,0.001169,0.000134
371830525031001,3,5,5,13,347,2.327791,0,0
371830528071005,3,5,5,13,101,1.819845,0,0
371830526012008,1,4,4,9,28,0.473935,0.004062,0.000127
371830541044020,2,4,4,10,207,1.065801,0.011337,0.000103
371830541101009,5,5,5,15,91,3.35999,0,0
371830540181010,2,5,5,12,25,1.473685,0,0
371830521011029,2,4,4,10,50,1.267046,0.002514,0.000107
371830537252021,2,4,4,10,105,1.145271,0.0085,0.000147
371830524063017,3,5,5,13,22,2.081733,0,0
371830541052036,3,5,5,13,12,1.905114,0,0
371830541102010,5,5,5,15,66,3.960336,0,0
371830540141063,2,4,4,10,112,0.99396,0.001332,0.00017
371830525033013,2,4,5,11,4,0.998814,0.004523,9.4e-05
371830540012011,2,4,4,10,77,1.048023,0.005234,0.000171
371830537142020,1,3,3,7,39,0.424212,0.013421,0.000543
371830528062048,3,5,5,13,19,1.559775,0,0
371830541042029,2,1,4,7,36,1.230727,0.03317,0.0002
371830540141026,2,5,5,12,190,1.357293,0,0
371830520021013,1,4,4,9,70,0.517252,0.006846,0.000189
371830537171005,4,5,5,14,369,3.095525,0,0
371830517002003,1,4,4,9,43,0.567741,0.005353,0.000502
371830523011004,1,1,4,6,32,0.139824,0.035608,0.000257
371830515022006,1,4,4,9,81,0.329358,0.002668,0.000341
371830525031016,2,4,5,11,23,1.143554,0.004523,9.4e-05
371830540044001,2,4,4,10,1114,1.239778,0.002575,0.000102
371830541041040,2,1,4,7,107,0.756516,0.03317,0.0002
371830541062053,2,3,4,9,37,0.749013,0.016556,0.000185
371830521013006,2,4,4,10,59,1.199682,0.006613,0.000142
371830537142008,2,4,4,10,420,0.938713,0.002435,0.000119
371830537143013,2,5,4,11,118,0.971118,0.001169,0.000134
371830506002035,1,4,1,6,14,0.174927,0.005514,0.001581
371830521011016,2,4,4,10,193,0.804881,0.002993,0.000222
371830524062018,3,5,5,13,23,1.784893,0,0
371830510002019,1,2,2,5,51,0.23119,0.024164,0.001052
371830517001010,1,4,4,9,46,0.0517,0.004758,0.000362
371830540081000,2,4,4,10,27,0.701558,0.003023,0.000139
371830537181013,5,5,5,15,92,4.47228,0,0
371830523013011,2,1,5,8,291,0.697978,0.033889,7.2e-05
371830524011062,2,4,4,10,18,1.246435,0.00124,0.000144
371830509002030,1,2,2,5,192,0.224149,0.022195,0.001303
371830537163002,1,3,4,8,48,0.314805,0.014256,0.000338
371830541061004,3,5,5,13,88,2.220277,0,0
371830501001097,1,2,1,4,231,0.053643,0.023005,0.00183
371830528062033,3,5,5,13,28,2.048181,0,0
371830528072072,1,4,4,9,78,0.527461,0.010303,0.000189
371830537141003,2,4,5,11,34,1.079066,0.004246,8.2e-05
371830524092000,2,3,4,9,1231,0.745406,0.019121,0.000148
371830541054002,2,4,4,10,40,1.000684,0.011337,0.000103
371830540131007,2,4,4,10,143,1.276179,0.002632,0.000288
371830540071000,3,5,5,13,196,1.558942,0,0
371830520012011,2,4,2,8,16,0.854304,0.00289,0.00103
371830527061010,2,4,4,10,3,1.09883,0.002464,0.000129
371830537122013,2,4,5,11,55,0.980486,0.004246,8.2e-05
371830518003006,2,4,4,10,71,0.76229,0.004758,0.000362
371830537232008,2,5,4,11,1,1.06308,3.5e-05,0.000128
371830514001000,1,4,4,9,50,0.381626,0.003789,0.000471
371830521014012,1,4,4,9,84,0.470392,0.010524,0.000378
371830509001002,1,2,1,4,30,0.288573,0.027331,0.00205
371830528062044,3,5,5,13,1,2.240949,0,0
371830537163006,1,3,4,8,13,0.368335,0.016915,0.000407
371830524011036,4,5,5,14,11,3.146012,0,0
371830540162012,2,1,4,7,16,0.927448,0.059635,0.000247
371830537232003,1,5,4,10,637,0.471935,0,0.00013
371830530081014,2,1,4,7,4,1.134517,0.034432,0.000176
371830508003006,1,4,3,8,1779,0.467909,0.006357,0.000615
371830518002003,1,4,4,9,21,0.285196,0.004919,0.000462
371830542071094,3,5,5,13,123,1.943755,0,0
371830525031005,3,5,5,13,10,1.941148,0,0
371830524071028,1,4,4,9,40,0.598113,0.001783,0.000248
371830506002031,1,4,1,6,33,0.082785,0.005514,0.001581
371830537261003,2,4,4,10,85,0.698128,0.002435,0.000119
371830541103023,5,5,5,15,110,4.08529,0,0
371830541063036,2,3,4,9,246,0.944576,0.016556,0.000185
371830537111003,2,5,5,12,13,1.483774,0,0
371830523022005,1,4,4,9,73,0.568757,0.00545,0.000141
371830540072018,3,5,5,13,70,1.75839,0,0
371830537252020,2,4,4,10,5,0.908282,0.0085,0.000147
371830504002000,1,4,3,8,38,0.063048,0.006165,0.000854
371830524011095,3,5,5,13,4,2.024644,0,0
371830514001013,1,4,4,9,83,0.340365,0.003816,0.00053
371830540181009,2,5,5,12,58,1.33101,0,0
371830511012008,1,4,4,9,19,0.262896,0.002044,0.000235
371830528072036,3,5,5,13,3,1.977999,0,0
371830503001026,1,4,3,8,107,0.144457,0.006861,0.000633
371830542071023,4,5,5,14,156,3.183593,0,0
371830545001021,1,3,3,7,40,0.240533,0.020133,0.000728
371830537142002,2,4,4,10,48,1.219523,0.003604,0.000253
371830524011085,2,4,4,10,4,1.005688,0.00124,0.000144
371830512002011,1,4,3,8,19,0.18815,0.007506,0.000926
371830505001023,1,4,2,7,50,0.236106,0.006604,0.001238
371830537261007,1,4,4,9,61,0.284988,0.002435,0.000119
371830510002006,1,2,2,5,2,0.26735,0.021897,0.001348
371830542071052,5,5,5,15,3,3.346802,0,0
371830525032023,2,4,5,11,156,0.987719,0.004523,9.4e-05
371830515022016,1,4,4,9,23,0.285374,0.004393,0.000463
371830530081050,3,5,5,13,124,1.644666,0,0
371830542081090,3,5,5,13,239,2.308844,0,0
371830508001019,1,4,2,7,116,0.227936,0.007541,0.001158
371830540143001,2,5,5,12,25,1.32776,0,0
371830520024011,2,4,2,8,32,0.908548,0.00289,0.00103
371830537231015,1,5,4,10,51,0.496083,0,0.00013
371830537142026,2,2,3,7,347,0.721222,0.024506,0.000619
371830541052034,3,5,5,13,65,2.059006,0,0
371830540171032,2,4,4,10,334,1.120218,0.007237,0.000104
371830528072011,2,4,4,10,30,0.73694,0.010303,0.000189
371830507002006,1,4,1,6,34,0.082156,0.007747,0.001657
371830542071103,2,4,4,10,191,1.079922,0.002632,0.000288
371830524072017,1,1,4,6,21,0.134111,0.036848,0.0004
371830537171043,3,5,5,13,95,1.971121,0,0
371830541101000,5,5,5,15,244,3.410674,0,0
371830504002004,1,4,2,7,31,0.028876,0.004365,0.001192
371830523013001,2,1,4,7,208,0.972056,0.035084,0.000204
371830528061000,2,5,5,12,30,1.398127,0,0
371830537251018,2,5,5,12,78,1.372545,0,0
371830524092001,1,3,4,8,132,0.586481,0.019121,0.000148
371830540141082,2,5,5,12,71,1.50118,0,0
371830516001015,2,4,3,9,100,0.790115,0.007682,0.000797
371830525032025,1,4,4,9,144,0.479452,0.007505,0.00024
371830540122004,1,4,4,9,18,0.321735,0.007237,0.000104
371830528033000,3,5,5,13,678,2.053842,0,0
371830507003037,1,4,2,7,19,0.246976,0.008484,0.001314
371830541062043,2,3,4,9,33,0.878098,0.016556,0.000185
371830528062028,3,5,5,13,222,2.18724,0,0
371830519001047,1,4,4,9,90,0.617472,0.005034,0.000464
371830528063002,2,3,4,9,531,1.094163,0.016556,0.000185
371830537111013,3,5,5,13,204,1.868462,0,0
371830526023006,2,4,4,10,42,0.974712,0.002575,0.000102
371830503002007,1,2,2,5,8,0.49646,0.022487,0.001177
371830537232004,2,5,4,11,66,1.132929,3.5e-05,0.000258
371830540141021,3,5,5,13,42,1.571073,0,0
371830526021003,1,4,5,10,42,0.61657,0.002659,6.9e-05
371830537241069,2,4,4,10,154,1.270333,0.0085,0.000147
371830540072003,3,5,5,13,5,1.58954,0,0
371830537111021,2,5,5,12,47,1.312945,0,0
371830503001018,1,4,3,8,156,0.198873,0.007124,0.000746
371830512003014,1,4,3,8,17,0.149254,0.00815,0.000695
371830541063001,2,3,4,9,175,0.929921,0.016556,0.000185
371830541043020,2,1,4,7,456,1.160544,0.03317,0.0002
371830527051016,1,4,4,9,129,0.492463,0.002464,0.000129
371830524043008,2,1,4,7,158,0.756336,0.035627,0.000309
371830540141015,2,4,4,10,62,0.919926,0.001332,0.00017
371830516002013,1,5,5,11,141,0.588751,0.001038,7e-05
371830524041025,2,1,4,7,39,0.680774,0.036848,0.0004
371830541054015,2,4,4,10,112,1.114127,0.011337,0.000103
371830524081001,1,4,4,9,48,0.574699,0.002044,0.000235
371830541044009,2,5,5,12,20,1.454476,0,0
371830537171003,4,5,5,14,5,2.471041,0,0
371830540161000,2,1,4,7,164,0.976404,0.059635,0.000247
371830524062020,4,5,5,14,39,2.456655,0,0
371830540141058,2,4,4,10,11,0.70331,0.001332,0.00017
371830541103017,5,5,5,15,81,3.60387,0,0
371830524062030,2,5,5,12,332,1.293726,0,0
371830542071044,4,5,5,14,61,2.504872,0,0
371830511012003,1,4,4,9,180,0.197873,0.002025,0.000182
371830521021016,2,5,4,11,30,0.902763,0.000247,0.000338
371830537141010,1,4,5,10,75,0.574791,0.004246,8.2e-05
371830525071008,2,4,4,10,44,1.184455,0.010986,0.000424
371830521011001,1,4,4,9,200,0.387817,0.009606,0.000363
371830528072028,1,4,4,9,2,0.622532,0.010303,0.000189
371830515012038,2,4,3,9,39,0.729144,0.00533,0.000602
371830509003014,1,2,2,5,47,0.080454,0.026092,0.001338
371830537121007,3,5,5,13,22,1.92581,0,0
371830515012021,2,4,4,10,58,0.709518,0.005651,0.000487
371830542071096,3,5,5,13,33,2.103929,0,0
371830541063000,1,3,4,8,1113,0.566428,0.016556,0.000185
371830516003008,1,4,4,9,31,0.585876,0.004512,0.000416
371830537261000,2,4,4,10,45,1.101337,0.002435,0.000119
371830537131009,2,4,4,10,282,0.838534,0.002435,0.000119
371830528061006,2,5,5,12,130,1.521741,0,0
371830525033029,2,4,5,11,113,0.657285,0.004523,9.4e-05
371830540042005,1,4,4,9,51,0.623998,0.009896,0.000173
371830540151013,1,4,4,9,76,0.095279,0.003023,0.000139
371830527041000,2,4,5,11,196,0.846582,0.002298,8.6e-05
371830521011032,2,5,5,12,8,1.379786,0,0
371830530081061,3,5,5,13,8,1.537579,0,0
371830541054000,2,1,4,7,45,1.134083,0.044507,0.000303
371830525051014,2,3,4,9,61,1.175834,0.015238,0.00041
371830527043017,1,4,4,9,58,0.354852,0.004763,0.000215
371830527063000,3,5,5,13,73,1.554417,0,0
371830512001005,1,4,3,8,48,0.396743,0.006861,0.000633
371830540161004,2,1,4,7,13,0.934182,0.059635,0.000247
371830526011007,2,3,4,9,186,0.702164,0.018318,0.000465
371830541102022,5,5,5,15,46,3.940815,0,0
371830511011004,2,4,4,10,1121,0.649412,0.004884,0.000277
371830537152011,2,5,4,11,151,1.029135,0.001169,0.000134
371830536102022,1,4,4,9,78,0.610493,0.001964,0.000197
371830520023000,2,4,4,10,454,0.739456,0.006846,0.000189
371830512003009,1,4,3,8,124,0.215709,0.0067,0.000533
371830537211021,3,5,5,13,11,1.659919,0,0
371830541063006,2,3,4,9,179,1.168037,0.016556,0.000185
371830537262003,3,5,5,13,45,1.577167,0,0
371830507002012,1,4,2,7,195,0.414377,0.007472,0.001377
371830540132053,2,5,5,12,118,1.384862,0,0
371830514005020,1,4,3,8,43,0.092612,0.00815,0.000695
371830540061011,2,4,4,10,180,0.940505,0.002694,0.000197
371830524011027,4,5,5,14,186,2.799545,0,0
371830524072024,1,4,4,9,4,0.415145,0.001783,0.000248
371830519002008,1,4,3,8,61,0.599123,0.00604,0.000543
371830527052011,1,4,4,9,91,0.26598,0.004763,0.000215
371830538083001,1,4,4,9,12,0.392543,0.002632,0.000288
371830545001018,1,3,2,6,48,0.155677,0.021678,0.001069
371830508002001,1,4,2,7,58,0.159812,0.010095,0.001306
371830536102025,1,4,4,9,85,0.553486,0.001964,0.000197
371830540162009,2,1,4,7,108,0.96317,0.059635,0.000247
371830537071018,2,5,4,11,129,0.968583,0.001169,0.000134
371830525061007,2,3,4,9,170,1.092144,0.01352,0.000195
371830521011010,2,4,4,10,93,0.918465,0.009606,0.000363
371830525043013,1,4,4,9,9,0.300559,0.007505,0.00024
371830515021001,1,4,4,9,538,0.555768,0.005239,0.000396
371830523022007,1,4,4,9,72,0.507713,0.00545,0.000141
371830537111014,3,5,5,13,134,1.633869,0,0
371830506002015,1,4,2,7,37,0.109781,0.007091,0.001245
371830540131052,2,5,5,12,43,1.325451,0,0
371830541132038,3,5,5,13,66,2.338161,0,0
371830537111029,3,5,5,13,45,1.579618,0,0
371830528033034,2,5,5,12,243,1.389091,0,0
371830540141036,2,5,5,12,31,1.3367,0,0
371830540171023,2,4,4,10,25,1.19263,0.007237,0.000104
371830528064007,2,5,5,12,90,1.444324,0,0
371830527042007,1,4,5,10,404,0.484916,0.002298,8.6e-05
371830536101015,3,5,5,13,150,2.202164,0,0
371830540181028,1,4,5,10,163,0.555213,0.002298,8.6e-05
371830525033002,3,5,5,13,41,1.574938,0,0
371830517001000,1,4,3,8,99,0.275637,0.009511,0.000789
371830528072022,2,4,4,10,45,0.714214,0.010303,0.000189
371830526032002,2,4,3,9,128,1.029619,0.008856,0.000655
371830537231008,2,5,4,11,209,0.705525,0,0.00013
371830521022000,1,4,4,9,1414,0.039336,0.004318,0.000372
371830540143007,3,5,5,13,164,1.8964,0,0
371830527052037,2,4,4,10,433,1.077401,0.003061,0.000127
371830530082000,2,5,5,12,394,1.426066,0,0
371830527072007,2,3,4,9,31,1.095465,0.013802,0.000231
371830521012011,1,3,3,7,138,0.399136,0.014794,0.000604
371830540134019,3,5,5,13,79,2.06634,0,0
370630020282014,2,4,4,10,38,0.986138,0.001964,0.000197
371830537222005,2,5,4,11,67,1.011198,0,0.00013
371830537223000,1,4,4,9,410,0.472974,0.010065,0.000201
371830515012001,2,4,4,10,53,1.056304,0.004021,0.000216
371830527063002,3,5,5,13,190,1.714825,0,0
371830505001005,1,4,2,7,29,0.143179,0.006486,0.001057
371830541061000,4,5,5,14,612,2.487816,0,0
371830528063019,2,3,4,9,14,1.283778,0.016556,0.000185
371830501001006,1,4,1,6,2,0.482636,0.004841,0.001516
371830524072002,2,4,4,10,14,0.706893,0.00124,0.000144
371830519002014,1,4,4,9,41,0.347952,0.005034,0.000464
371830541044012,3,5,5,13,165,1.578848,0,0
371830509001021,1,2,1,4,31,0.106296,0.027283,0.001904
371830542071088,2,4,4,10,243,1.277498,0.002632,0.000288
371830526021025,2,4,4,10,136,0.884333,0.005234,0.000171
371830521022003,1,4,4,9,38,0.091692,0.010931,0.000513
371830537113011,1,3,4,8,54,0.444882,0.012746,0.000229
371830528064034,3,5,5,13,79,1.914059,0,0
371830537151008,1,3,4,8,20,0.16977,0.012254,0.000211
371830505001026,1,4,2,7,16,0.191597,0.006662,0.001255
371830526021004,2,4,4,10,62,0.642022,0.005234,0.000171
371830537252039,3,5,5,13,97,1.812912,0,0
371830516005018,1,4,3,8,43,0.61177,0.004054,0.000549
371830530081023,2,5,5,12,145,1.339011,0,0
371830540132019,2,4,4,10,85,1.076043,0.002632,0.000288
371830509002001,1,2,1,4,41,0.244266,0.026833,0.001782
371830520023002,1,4,4,9,282,0.630156,0.006846,0.000189
371830541044008,2,4,4,10,27,1.27347,0.011337,0.000103
371830507001015,1,4,1,6,52,0.209412,0.00789,0.001741
371830540013000,1,4,4,9,1316,0.60273,0.005553,0.000163
371830536101042,2,4,4,10,62,0.696218,0.001964,0.000197
371830541052026,3,5,5,13,45,1.822249,0,0
371830540012000,2,4,4,10,325,0.66993,0.009896,0.000173
371830542071086,3,5,5,13,340,1.764713,0,0
371830540011009,1,4,5,10,115,0.422497,0.002659,6.9e-05
371830541042016,2,1,4,7,330,1.08963,0.03317,0.0002
371830528072024,2,4,4,10,13,0.964334,0.010303,0.000189
371830537121005,2,5,5,12,1,1.302512,0,0
371830537111008,3,5,5,13,23,1.976096,0,0
371830536102012,1,4,4,9,68,0.45181,0.001964,0.000197
371830525052011,2,4,4,10,23,0.850322,0.007136,0.00048
371830537141012,2,4,4,10,69,0.924017,0.006681,0.0002
371830545001035,1,3,3,7,18,0.251411,0.019889,0.000608
371830520012013,1,4,3,8,98,0.617187,0.003163,0.000883
371830540122000,2,4,4,10,490,1.233652,0.007237,0.000104
371830540111011,2,5,5,12,243,1.293052,0,0
371830501001057,1,2,1,4,4,0.11457,0.027217,0.001668
371830541054003,2,4,4,10,34,0.86252,0.011337,0.000103
371830525061006,2,3,3,8,313,1.002181,0.013421,0.000543
371830528072017,2,4,4,10,98,0.637978,0.010303,0.000189
371830537181024,5,5,5,15,53,3.905387,0,0
371830537171017,4,5,5,14,5,3.32547,0,0
371830526031004,1,4,4,9,28,0.527426,0.004153,0.000334
371830541103025,5,5,5,15,2,4.522117,0,0
371830507002008,1,4,2,7,54,0.093019,0.003846,0.001333
371830540132041,3,5,5,13,92,1.566607,0,0
371830521011018,1,4,4,9,449,0.440975,0.009606,0.000363
371830528062034,3,5,5,13,21,2.046067,0,0
371830520021008,1,4,4,9,39,0.312332,0.006846,0.000189
371830528064059,3,5,5,13,37,1.757929,0,0
371830541061029,3,5,5,13,42,2.21182,0,0
371830545003031,2,5,5,12,17,1.39265,0,0
371830530081032,2,5,5,12,69,1.351895,0,0
371830506002023,1,4,3,8,16,0.209044,0.005604,0.000773
371830524011037,4,5,5,14,5,2.822638,0,0
371830545004012,1,4,4,9,12,0.266679,0.00545,0.000141
371830528072029,2,4,4,10,11,0.840491,0.010303,0.000189
371830525041006,2,4,4,10,13,1.259821,0.001218,0.00018
371830528063000,2,5,5,12,32,1.367635,0,0
371830512001000,1,4,3,8,596,0.221408,0.00815,0.000695
371830541041026,2,4,4,10,45,1.148547,0.003023,0.000139
371830507003000,1,4,3,8,33,0.446182,0.005775,0.000901
371830540112003,2,2,3,7,68,1.029747,0.025679,0.000856
371830540181000,2,5,5,12,7,1.415911,0,0
371830508003005,1,4,2,7,55,0.267147,0.008278,0.001275
371830507001020,1,4,1,6,56,0.22821,0.005535,0.001653
371830528061007,2,5,5,12,5,1.316834,0,0
371830527051032,2,4,4,10,40,0.761676,0.004763,0.000215
371830524011042,4,5,5,14,30,2.686821,0,0
371830542071070,4,5,5,14,80,2.531692,0,0
371830528033024,2,5,5,12,104,1.449905,0,0
371830516005017,2,4,3,9,37,0.713739,0.005019,0.000596
371830511012004,1,5,4,10,72,0.396135,0.000868,0.000154
371830524011022,4,5,5,14,68,3.015677,0,0
371830537091001,3,5,5,13,89,1.584753,0,0
371830528072076,1,4,4,9,88,0.474019,0.010303,0.000189
371830537192007,5,5,5,15,403,4.403408,0,0
371830521014028,1,3,3,7,25,0.27328,0.011826,0.000641
371830524011063,3,5,5,13,17,1.90558,0,0
371830538083031,2,4,4,10,4,0.655166,0.002632,0.000288
371830514001014,1,4,4,9,91,0.338812,0.003816,0.00053
371830540143004,3,5,5,13,338,1.896074,0,0
371830541042022,1,1,4,6,371,0.563537,0.03317,0.0002
371830527071015,2,3,4,9,39,1.119681,0.013635,0.000189
371830506003014,1,4,1,6,46,0.11815,0.009329,0.00165
371830537113008,1,3,4,8,1,0.424172,0.012746,0.000229
371830540171017,2,1,4,7,5,1.111502,0.059635,0.000247
371830537171009,3,5,5,13,70,2.00451,0,0
371830541103003,5,5,5,15,206,4.178075,0,0
371830537112017,2,4,4,10,10,0.865984,0.0085,0.000147
371830537231004,2,4,4,10,36,1.001129,0.010065,0.000331
371830540141067,2,4,4,10,14,1.080047,0.001332,0.00017
371830545002007,1,4,1,6,62,0.087844,0.008963,0.00222
371830526012019,1,4,4,9,70,0.436292,0.008373,0.000528
371830541041034,2,1,4,7,6,1.278982,0.03317,0.0002
371830537141005,2,4,5,11,56,0.968522,0.004246,8.2e-05
371830501001095,1,2,1,4,2,0.043785,0.023533,0.001941
371830540071001,3,5,5,13,962,1.905224,0,0
371830523022016,1,4,4,9,64,0.369034,0.00545,0.000141
371830537192006,5,5,5,15,235,4.10615,0,0
371830504002014,1,4,2,7,17,0.246911,0.004604,0.001397
371830536102011,2,4,4,10,46,0.699377,0.001964,0.000197
371830540132054,2,4,4,10,49,1.232293,0.002632,0.000288
371830541102019,5,5,5,15,67,3.857894,0,0
371830536101038,2,5,5,12,18,1.382663,0,0
371830540123002,2,4,4,10,409,1.235869,0.007237,0.000104
371830521012014,1,4,4,9,54,0.283712,0.010931,0.000513
371830509001019,1,2,1,4,21,0.009613,0.027331,0.00205
371830526021005,2,4,5,11,217,0.675032,0.002659,6.9e-05
371830517003026,2,4,4,10,49,1.033258,0.001689,0.000273
371830516003000,2,4,4,10,8,1.018965,0.002711,0.000231
371830545001026,1,3,3,7,58,0.326634,0.020215,0.000854
371830537121015,1,4,5,10,55,0.304981,0.004246,8.2e-05
371830528064035,3,5,5,13,56,2.006371,0,0
371830527072008,2,3,4,9,36,1.010483,0.0161,0.000318
371830537073000,1,5,4,10,119,0.514194,3.5e-05,0.000258
371830530081001,3,5,5,13,288,1.60732,0,0
371830541062027,2,4,4,10,5,0.731855,0.006846,0.000189
371830540134008,3,5,5,13,52,1.999596,0,0
371830541043027,3,5,5,13,142,1.771704,0,0
371830507003035,1,4,2,7,11,0.213718,0.008484,0.001314
371830525031010,2,5,5,12,117,1.466698,0,0
371830523023014,2,4,4,10,292,1.246287,0.00545,0.000141
371830527061024,2,4,4,10,30,1.197927,0.011337,0.000103
371830540081009,1,4,4,9,41,0.345589,0.003023,0.000139
371830542091074,4,5,5,14,279,3.006616,0,0
371830541054025,2,4,4,10,80,0.641474,0.011337,0.000103
371830523022009,1,3,4,8,286,0.467434,0.021712,0.000194
371830510002022,1,2,2,5,17,0.136636,0.025013,0.001274
371830540142010,2,4,4,10,27,0.709754,0.001332,0.00017
371830525043011,1,4,4,9,13,0.222715,0.007597,0.000446
371830540012015,2,4,4,10,11,1.030518,0.005234,0.000171
371830537131007,2,4,5,11,38,1.235233,0.004246,8.2e-05
371830540061000,3,5,5,13,26,1.568698,0,0
371830518001030,1,4,4,9,46,0.255462,0.003177,0.000397
371830537252011,2,4,4,10,43,0.770321,0.0085,0.000147
371830537171025,4,5,5,14,51,2.615607,0,0
371830545002082,2,3,1,6,52,0.972681,0.014414,0.002361
371830537261009,1,4,4,9,195,0.47219,0.002435,0.000119
371830541042000,2,1,4,7,69,0.820212,0.03317,0.0002
371830540043007,2,4,4,10,366,1.283543,0.007237,0.000104
371830526011019,2,4,4,10,26,0.86783,0.004062,0.000127
371830527052002,1,4,4,9,207,0.416007,0.004763,0.000215
371830541101008,5,5,5,15,181,3.560079,0,0
371830536101026,3,5,5,13,40,1.88258,0,0
371830541103019,5,5,5,15,29,3.511954,0,0
371830538082013,3,5,5,13,55,1.581624,0,0
371830545002006,2,3,1,6,175,0.876759,0.011732,0.00159
371830540082003,1,4,4,9,213,0.613587,0.003023,0.000139
371830528064036,3,5,5,13,102,1.916753,0,0
371830537112008,2,3,4,9,103,0.853451,0.012746,0.000229
371830528061008,2,4,4,10,20,0.857701,0.010303,0.000189
371830528064037,3,5,5,13,53,1.9425,0,0
371830512001008,1,4,3,8,85,0.413766,0.0067,0.000533
371830509001000,1,2,1,4,2,0.07356,0.026628,0.001813
371830526011017,2,4,4,10,24,0.730839,0.004062,0.000127
371830524081012,1,4,4,9,30,0.263942,0.002044,0.000235
371830526012021,1,4,4,9,47,0.273408,0.007723,0.000326
371830542081114,3,5,5,13,510,2.111854,0,0
371830541103014,5,5,5,15,66,4.533304,0,0
371830537141013,2,4,5,11,56,0.689299,0.004246,8.2e-05
371830540072001,3,5,5,13,265,1.717209,0,0
371830540162004,1,1,4,6,835,0.239904,0.059635,0.000247
371830541053013,4,5,5,14,79,2.440794,0,0
371830542071032,4,5,5,14,307,2.710797,0,0
371830542071057,4,5,5,14,334,3.273654,0,0
371830537131001,1,4,5,10,47,0.295175,0.004246,8.2e-05
371830526012002,2,4,4,10,42,0.743828,0.007723,0.000326
371830540134043,3,5,5,13,30,1.54745,0,0
371830537131011,2,4,4,10,41,0.746543,0.002435,0.000119
371830516003001,2,4,4,10,48,0.940767,0.003754,0.000332
371830509003004,1,2,1,4,51,0.005439,0.027283,0.001904
371830504001033,1,4,3,8,58,0.202204,0.005741,0.000796
371830507001022,1,4,1,6,80,0.251381,0.007894,0.001742
371830538082006,2,2,3,7,34,0.798288,0.025679,0.000856
371830542091050,5,5,5,15,291,3.471122,0,0
371830503001000,1,4,4,9,39,0.357772,0.003822,0.000417
371830507003041,1,4,1,6,49,0.2783,0.009288,0.001565
371830538082016,3,5,5,13,158,1.841335,0,0
371830541052012,3,5,5,13,3,1.694548,0,0
371830506001003,1,4,3,8,103,0.108451,0.00662,0.000932
371830541062055,2,3,4,9,111,1.281584,0.016556,0.000185
371830521011035,2,4,4,10,54,1.19976,0.002514,0.000107
371830540083005,2,5,5,12,251,1.36516,0,0
371830506002029,1,4,2,7,48,0.155578,0.005188,0.001334
371830525031008,2,5,5,12,134,1.433104,0,0
371830521014009,1,3,3,7,1,0.387335,0.014959,0.000673
371830541043033,3,5,5,13,99,1.987816,0,0
371830521013003,2,4,4,10,191,1.149089,0.007092,0.000256
371830526031005,1,4,3,8,69,0.426844,0.009064,0.000828
371830516002010,2,4,4,10,38,0.74498,0.002711,0.000231
371830537224003,2,4,4,10,182,1.029981,0.010065,0.000331
371830520023001,2,4,4,10,37,0.695236,0.006846,0.000189
371830524082012,1,5,4,10,33,0.428668,0.001195,0.000132
371830537241039,3,5,5,13,22,1.724607,0,0
371830528072009,2,4,4,10,21,0.672557,0.010303,0.000189
370630020282020,2,4,4,10,6,0.896037,0.001964,0.000197
371830528061012,1,4,4,9,87,0.285211,0.010303,0.000189
371830537132005,1,4,5,10,21,0.576641,0.004246,8.2e-05
371830541062052,1,3,4,8,8,0.54833,0.016556,0.000185
371830540131046,2,1,4,7,155,0.813146,0.076914,0.000488
371830525032004,2,4,5,11,128,1.104941,0.004523,9.4e-05
371830541043014,2,4,4,10,3,1.188694,0.003023,0.000139
371830521012000,1,3,3,7,28,0.452124,0.014959,0.000673
371830537171011,3,5,5,13,55,2.214591,0,0
371830507001005,1,4,1,6,40,0.223346,0.00489,0.001646
371830540143016,2,5,5,12,34,1.420242,0,0
371830501001103,1,2,1,4,2,0.119176,0.023463,0.001871
371830520021009,2,4,4,10,45,0.691752,0.006846,0.000189
371830525033017,2,4,5,11,469,0.932616,0.004523,9.4e-05
371830505003020,1,4,4,9,34,0.170226,0.004903,0.000271
371830540161007,1,1,4,6,169,0.450752,0.059635,0.000247
371830541043028,3,5,5,13,212,1.584998,0,0
371830515012015,2,4,3,9,52,0.71205,0.004292,0.000532
371830536101033,3,5,5,13,25,1.86711,0,0
371830542071066,4,5,5,14,98,3.04414,0,0
371830517001015,1,4,4,9,43,0.090315,0.004919,0.000462
371830527012013,2,4,4,10,333,1.128964,0.002575,0.000102
371830519001029,2,4,4,10,2,0.863169,0.001473,0.000378
371830514005023,1,4,3,8,37,0.012582,0.00815,0.000695
371830505003015,1,4,5,10,52,0.333549,0.003562,8.6e-05
371830514001015,1,4,3,8,56,0.329892,0.006656,0.000573
371830541052025,3,5,5,13,86,1.886701,0,0
371830536101053,2,4,4,10,47,0.847528,0.001964,0.000197
371830506002017,1,4,2,7,20,0.049429,0.005188,0.001334
371830545001027,1,2,1,4,141,0.502519,0.022247,0.002887
371830523023017,2,5,5,12,39,1.360886,0,0
371830541103020,5,5,5,15,92,4.575218,0,0
371830509003008,1,2,1,4,38,0.082461,0.026833,0.001782
371830527063013,3,5,5,13,35,1.934697,0,0
371830541132040,3,5,5,13,84,2.369993,0,0
371830524041010,2,1,4,7,73,0.641414,0.036848,0.0004
371830519002000,2,4,5,11,345,0.722868,0.003562,8.6e-05
371830540062004,1,4,4,9,56,0.604456,0.005588,0.000292
371830526011015,2,4,4,10,35,0.893973,0.004062,0.000127
371830512002005,1,4,3,8,77,0.123485,0.0067,0.000533
371830525072019,2,5,5,12,33,1.327015,0,0
371830536102021,2,4,4,10,51,0.814335,0.001964,0.000197
371830540151000,2,5,5,12,3,1.300218,0,0
371830542091064,4,5,5,14,66,3.21595,0,0
371830521021020,1,4,4,9,278,0.447027,0.003839,0.000257
371830537072002,1,5,4,10,70,0.628879,0.001204,0.000392
371830519001023,2,5,4,11,126,1.044349,0.000694,0.000175
371830541062028,2,4,4,10,32,0.978723,0.006846,0.000189
371830536101075,3,5,5,13,80,1.86151,0,0
371830514002000,1,4,3,8,79,0.225552,0.006832,0.000633
371830540161006,2,1,4,7,95,0.635317,0.059635,0.000247
370630019002073,5,5,5,15,56,4.623173,0,0
371830545001004,1,2,2,5,110,0.152471,0.025035,0.001346
371830537152001,1,5,4,10,273,0.615041,0.001169,0.000134
371830541052018,2,5,5,12,35,1.368293,0,0
371830521012006,1,4,4,9,177,0.182951,0.010931,0.000513
371830545004001,1,4,4,9,35,0.545425,0.00545,0.000141
371830524061001,2,5,5,12,45,1.430534,0,0
371830508002009,1,3,2,6,84,0.241499,0.01673,0.001252
371830540084002,2,5,5,12,1253,1.329291,0,0
371830537112021,2,4,5,11,8,0.784597,0.004246,8.2e-05
371830540112006,2,5,5,12,30,1.30173,0,0
371830540012005,1,4,5,10,62,0.199892,0.002659,6.9e-05
371830542071085,3,5,5,13,165,1.846448,0,0
371830523022017,1,4,4,9,185,0.325025,0.00545,0.000141
371830536101030,3,5,5,13,31,1.816128,0,0
371830528062045,3,5,5,13,75,1.675157,0,0
371830527052027,2,4,4,10,185,1.277076,0.003061,0.000127
371830540181014,2,4,4,10,2,0.915925,0.005321,0.000225
371830537072019,1,3,4,8,120,0.556334,0.015425,0.000472
371830527061007,2,5,5,12,638,1.375211,0,0
371830505002009,1,4,4,9,35,0.259585,0.00498,0.000435
371830537143003,2,4,5,11,188,1.177225,0.004246,8.2e-05
371830541103036,5,5,5,15,8,4.401751,0,0
371830512003010,1,4,3,8,60,0.137756,0.0067,0.000533
371830528072074,1,4,4,9,72,0.453706,0.010303,0.000189
371830527011004,1,4,4,9,118,0.512082,0.005234,0.000171
371830537241041,3,5,5,13,83,1.873687,0,0
371830545004000,1,4,4,9,14,0.472744,0.00545,0.000141
371830527073002,2,4,4,10,9,1.280957,0.011337,0.000103
371830526032007,1,3,3,7,70,0.520355,0.012516,0.000853
371830521021039,2,5,5,12,19,1.353957,0,0
371830519001042,1,4,4,9,46,0.449426,0.005022,0.000526
371830518001032,1,4,4,9,36,0.137498,0.003177,0.000397
371830528071001,4,5,5,14,5,2.925062,0,0
371830517003007,2,4,4,10,39,0.711692,0.004062,0.000127
371830537152014,1,3,4,8,147,0.575919,0.012254,0.000211
371830517003018,2,4,3,9,6,1.110201,0.004402,0.000607
371830537073009,2,4,4,10,636,0.63805,0.005588,0.000292
371830537262014,2,5,5,12,2,1.519626,0,0
371830537222007,2,5,4,11,691,1.196243,0,0.00013
371830517003011,2,4,4,10,43,0.67646,0.008373,0.000528
371830524082010,1,5,4,10,97,0.440524,0.001195,0.000132
371830523013031,2,1,5,8,7,1.226827,0.033889,7.2e-05
371830505003017,1,4,4,9,29,0.115152,0.004567,0.000165
371830542071068,3,5,5,13,307,2.389731,0,0
371830519003014,1,4,4,9,25,0.393423,0.005034,0.000464
371830515012006,1,4,3,8,32,0.6009,0.009853,0.000696
371830536101078,3,5,5,13,167,1.900339,0,0
371830537241054,2,4,4,10,53,1.287384,0.0085,0.000147
371830524041005,1,1,4,6,18,0.23653,0.036867,0.000452
371830527013006,2,5,5,12,1113,1.352362,0,0
371830537092010,3,5,5,13,41,1.635428,0,0
371830525052000,2,4,5,11,116,0.946851,0.011085,7.7e-05
371830503001015,1,4,4,9,37,0.296081,0.001655,0.000221
371830541052022,2,4,4,10,90,1.174515,0.011337,0.000103
371830541043000,3,5,5,13,191,1.589634,0,0
371830541102012,5,5,5,15,108,3.794986,0,0
371830541055010,3,5,5,13,120,1.716298,0,0
371830537131014,2,4,4,10,16,0.648914,0.002435,0.000119
371830511021016,1,2,3,6,317,0.039125,0.022962,0.000586
371830528062029,3,5,5,13,46,1.875036,0,0
371830540071009,3,5,5,13,4,1.782993,0,0
371830527051012,1,4,4,9,62,0.030444,0.004763,0.000215
371830526021011,2,4,4,10,77,1.062748,0.005553,0.000163
371830530081057,1,1,5,7,76,0.386285,0.033889,7.2e-05
371830528062011,3,5,5,13,113,1.565509,0,0
371830541052017,3,5,5,13,91,1.790876,0,0
371830514001017,1,4,3,8,30,0.104538,0.006832,0.000633
371830541061010,3,5,5,13,42,2.382467,0,0
371830524061007,3,5,5,13,30,1.836139,0,0
371830503001007,1,4,4,9,24,0.359489,0.003822,0.000417
371830541051021,3,5,5,13,117,2.156924,0,0
371830526022001,1,4,4,9,107,0.401464,0.002575,0.000102
371830509003013,1,2,1,4,68,0.117312,0.027158,0.00153
371830541061044,2,3,4,9,58,1.135918,0.016556,0.000185
371830542071074,3,5,5,13,45,2.33669,0,0
371830527051022,2,4,4,10,36,0.890537,0.004763,0.000215
371830523013029,2,5,5,12,53,1.497292,0,0
371830540131033,2,1,4,7,77,1.281889,0.076914,0.000488
371830523023029,1,4,4,9,10,0.623786,0.00545,0.000141
371830545003024,2,4,4,10,10,0.859824,0.00545,0.000141
371830541102026,5,5,5,15,3,3.832326,0,0
371830525041011,2,5,5,12,102,1.307954,0,0
371830536102009,1,4,4,9,24,0.539766,0.001964,0.000197
371830526032017,1,3,2,6,15,0.494175,0.013167,0.001056
371830526031007,1,4,3,8,46,0.348009,0.009064,0.000828
371830506001008,1,4,3,8,103,0.132255,0.006516,0.000791
371830541041002,3,5,5,13,202,2.022568,0,0
371830506002016,1,4,1,6,34,0.060653,0.008749,0.00142
371830528064019,2,4,4,10,144,0.9947,0.010303,0.000189
371830537162011,1,3,4,8,63,0.563935,0.018318,0.000465
371830528033005,3,5,5,13,119,1.796588,0,0
371830520023007,1,4,4,9,51,0.482448,0.006846,0.000189
371830530081011,2,1,5,8,245,0.975882,0.033889,7.2e-05
371830537221004,2,5,5,12,141,1.347538,0,0
371830545003020,2,5,5,12,373,1.486867,0,0
371830528072026,2,4,4,10,9,0.916066,0.010303,0.000189
371830537132003,1,4,5,10,20,0.292993,0.004246,8.2e-05
371830506002014,1,4,2,7,44,0.194671,0.00703,0.001186
371830540171020,2,4,4,10,97,1.257339,0.007237,0.000104
371830512001004,1,4,3,8,56,0.470907,0.0067,0.000533
371830519001021,1,4,3,8,38,0.355292,0.006812,0.000869
371830540141059,2,4,4,10,51,0.774708,0.001332,0.00017
371830514005013,1,4,3,8,11,0.171181,0.00815,0.000695
371830524061009,2,5,4,11,268,1.273962,0.000543,0.000105
371830541044007,2,4,4,10,65,1.170937,0.011337,0.000103
371830514001009,1,4,3,8,54,0.206157,0.005134,0.000592
371830528064022,3,5,5,13,161,1.536,0,0
371830518002012,1,4,4,9,98,0.370439,0.006237,0.000524
370630020282017,2,4,4,10,2,1.077656,0.001964,0.000197
371830537112028,1,3,4,8,151,0.364858,0.012746,0.000229
371830537162008,2,3,4,9,41,0.751622,0.014256,0.000338
371830541062037,1,3,4,8,42,0.583998,0.016556,0.000185
371830525033026,2,4,5,11,35,0.805464,0.004523,9.4e-05
371830518001031,1,4,4,9,44,0.197607,0.003177,0.000397
371830537161002,1,3,4,8,44,0.245775,0.014256,0.000338
371830525072012,3,5,5,13,227,1.561504,0,0
371830537142031,2,3,4,9,82,0.771463,0.01352,0.000195
371830537231003,2,4,4,10,29,0.89876,0.010065,0.000331
371830501001060,1,2,2,5,1,0.289779,0.022205,0.001144
371830528072002,2,4,4,10,91,0.966192,0.010303,0.000189
371830524062022,3,5,5,13,30,2.37621,0,0
371830505003006,1,4,5,10,39,0.612288,0.003562,8.6e-05
371830527012012,2,4,4,10,52,1.000179,0.002575,0.000102
371830528063005,2,3,4,9,87,1.08178,0.016556,0.000185
371830516002009,2,4,4,10,45,1.086437,0.00255,0.000131
371830541042007,1,1,4,6,32,0.274247,0.03317,0.0002
371830541043049,2,4,4,10,4,0.902194,0.003023,0.000139
371830501001096,1,2,1,4,121,0.000864,0.023533,0.001941
371830540134009,3,5,5,13,40,2.086548,0,0
371830514002008,1,4,3,8,74,0.117072,0.006832,0.000633
371830523023023,2,4,4,10,17,1.177854,0.00545,0.000141
371830514003002,1,4,3,8,26,0.371088,0.005624,0.000621
371830540011011,1,4,4,9,34,0.535446,0.00583,0.00033
371830540011004,1,4,5,10,676,0,0.002659,6.9e-05
371830537142017,1,4,4,9,38,0.230796,0.002435,0.000119
371830516002019,1,4,4,9,15,0.078089,0.00418,0.000402
371830541052014,2,4,4,10,39,1.158604,0.011337,0.000103
371830519002019,1,4,3,8,245,0.334076,0.006445,0.00072
371830541063016,2,5,5,12,64,1.291861,0,0
371830545001010,1,2,2,5,105,0.249396,0.02191,0.001069
371830510002018,1,2,3,6,39,0.258775,0.022292,0.000701
371830528033050,3,5,5,13,125,1.586175,0,0
371830537261006,1,4,4,9,35,0.301071,0.002435,0.000119
371830528072080,2,4,4,10,31,1.289253,0.010303,0.000189
371830542091016,5,5,5,15,66,4.120559,0,0
371830541043017,2,4,4,10,83,0.857584,0.003023,0.000139
371830514004011,2,4,3,9,20,0.646204,0.007505,0.000675
371830545001025,1,3,3,7,65,0.332645,0.020133,0.000668
371830505001029,1,4,2,7,141,0.173897,0.004737,0.001268
371830526012010,2,4,3,9,345,0.91506,0.010948,0.00063
371830509001003,1,2,1,4,2,0.216141,0.027118,0.001834
371830537093027,3,5,5,13,19,2.368523,0,0
371830516003009,1,4,4,9,30,0.612113,0.003194,0.000355
371830537093028,4,5,5,14,51,2.588589,0,0
371830512003018,1,4,3,8,254,0.10771,0.0067,0.000533
371830524081004,1,4,4,9,43,0.630727,0.002587,0.000339
371830537113016,2,3,4,9,156,0.84742,0.015181,0.000348
371830537251028,2,3,4,9,193,1.007872,0.012746,0.000229
371830504002013,1,4,1,6,354,0.347773,0.00478,0.001457
371830540041004,1,4,4,9,36,0.539608,0.009896,0.000173
371830540163008,3,5,5,13,626,1.565411,0,0
371830506002013,1,4,2,7,17,0.239481,0.006626,0.00099
371830528033040,1,4,4,9,44,0.591773,0.002993,0.000222
371830525051010,2,3,4,9,8,0.792005,0.014256,0.000338
371830519001025,2,4,4,10,10,0.797771,0.001473,0.000378
371830537071027,1,5,4,10,48,0.538884,0.001169,0.000134
371830541055001,1,1,4,6,32,0.559993,0.03317,0.0002
371830521021048,2,5,5,12,51,1.425763,0,0
371830537093048,4,5,5,14,92,2.485737,0,0
371830524082001,1,5,4,10,90,0.067846,0.001195,0.000132
371830541053003,3,5,5,13,29,1.981712,0,0
371830517002018,1,4,4,9,80,0.514551,0.006237,0.000524
371830537252012,2,4,4,10,29,0.639893,0.0085,0.000147
371830540141030,2,5,5,12,135,1.328912,0,0
371830537152017,2,3,4,9,37,0.740863,0.012254,0.000211
371830540042006,2,4,4,10,85,1.214386,0.007237,0.000104
371830545004014,2,4,4,10,132,0.737754,0.00545,0.000141
371830540134035,3,5,5,13,28,1.797472,0,0
371830527052012,1,4,4,9,3,0.456352,0.004763,0.000215
371830525043005,2,4,4,10,86,0.742985,0.007505,0.00024
371830528033004,3,5,5,13,58,1.762527,0,0
371830537122001,2,4,4,10,35,0.939314,0.010065,0.000201
371830542071090,2,4,4,10,76,1.270403,0.002632,0.000288
371830537071001,2,5,4,11,112,0.750528,0.001169,0.000264
371830537181008,5,5,5,15,405,4.142052,0,0
371830537252043,3,5,5,13,119,1.642893,0,0
371830515012031,2,5,5,12,18,0.738194,0.001038,7e-05
371830525033027,2,4,5,11,2,1.048637,0.004523,9.4e-05
371830515011023,2,4,4,10,29,0.911291,0.004112,0.000423
371830512003007,1,4,3,8,34,0.163661,0.0067,0.000533
371830524011013,3,5,5,13,5,1.787986,0,0
371830525031002,3,5,5,13,39,1.697011,0,0
371830527061006,2,4,4,10,20,1.161952,0.011337,0.000103
371830537191001,5,5,5,15,316,4.211772,0,0
371830526023005,2,4,4,10,7,1.046619,0.010297,0.000428
371830530081031,2,5,5,12,26,1.425268,0,0
371830537122016,1,4,5,10,32,0.346042,0.004246,8.2e-05
371830528072040,4,5,5,14,15,3.127785,0,0
371830537142011,1,4,4,9,21,0.255968,0.002435,0.000119
371830537143001,2,4,5,11,22,1.081902,0.004246,8.2e-05
371830527073026,2,5,5,12,13,1.323884,0,0
371830540133001,3,5,5,13,2,1.582897,0,0
371830537211030,3,5,5,13,6,2.325215,0,0
371830521011008,2,4,4,10,461,0.997721,0.007092,0.000256
371830515022001,1,4,4,9,160,0.463998,0.002668,0.000341
371830540134011,2,5,5,12,107,1.373043,0,0
371830524011064,3,5,5,13,41,2.340062,0,0
371830540132042,2,5,5,12,44,1.391631,0,0
371830528064014,2,5,5,12,103,1.440177,0,0
371830521021022,1,4,4,9,38,0.484138,0.003839,0.000257
371830523023002,2,4,4,10,49,0.694641,0.00545,0.000141
371830540132028,2,5,5,12,139,1.314973,0,0
371830515012024,1,5,5,11,29,0.517803,0.001038,7e-05
371830501001016,1,4,1,6,2,0.486734,0.006475,0.001573
371830526032015,1,4,3,8,66,0.005611,0.008856,0.000655
371830537251014,2,3,4,9,29,0.953259,0.012746,0.000229
371830527051010,1,4,4,9,26,0.242805,0.004763,0.000215
371830542071114,4,5,5,14,65,3.071185,0,0
371830515021000,1,4,4,9,20,0.37506,0.005239,0.000396
371830525043040,2,4,5,11,21,0.690876,0.004523,9.4e-05
371830541132041,3,5,5,13,131,2.298581,0,0
371830525061017,2,4,4,10,57,0.638462,0.010986,0.000424
371830520021004,2,4,4,10,13,0.830302,0.007093,0.000528
371830512003024,1,4,3,8,34,0.128046,0.006943,0.000657
371830541051016,3,5,5,13,48,2.110736,0,0
371830537071024,1,5,4,10,18,0.563061,0.001169,0.000134
371830541051013,3,5,5,13,30,2.088582,0,0
371830527073025,2,4,4,10,67,1.2494,0.011337,0.000103
371830525051021,1,4,4,9,82,0.59168,0.004153,0.000334
371830516004008,1,4,4,9,35,0.346897,0.003789,0.000471
371830514001012,1,4,4,9,14,0.29696,0.003816,0.00053
371830521012003,1,3,3,7,36,0.374193,0.014794,0.000604
371830537092006,2,5,5,12,26,1.309739,0,0
371830537151004,1,3,3,7,87,0.285744,0.01546,0.0006
371830537262000,2,4,4,10,261,1.239112,0.006681,0.0002
371830537142018,1,4,4,9,26,0.22183,0.002435,0.000119
371830501001084,1,2,2,5,2,0.180303,0.021861,0.001244
371830505001003,1,4,2,7,54,0.349201,0.006368,0.001067
371830524011001,4,5,5,14,228,3.032477,0,0
371830542071056,4,5,5,14,4,3.07982,0,0
371830506001000,1,4,3,8,76,0.510104,0.006369,0.000771
371830537241022,2,4,4,10,109,1.129059,0.0085,0.000147
371830527013003,1,4,4,9,28,0.273202,0.002575,0.000102
371830525033021,2,4,5,11,1,1.131332,0.004523,9.4e-05
371830541062046,2,3,4,9,41,1.189148,0.016556,0.000185
371830525051023,1,4,4,9,11,0.537621,0.007136,0.00048
371830541055006,2,5,5,12,46,1.308008,0,0
371830506002030,1,4,2,7,10,0.07085,0.005188,0.001398
371830540181034,2,4,5,11,2,0.997262,0.002298,8.6e-05
371830521013007,2,4,4,10,135,1.17937,0.006613,0.000142
371830523021011,2,5,5,12,10,1.03243,1.9e-05,5.2e-05
371830514005005,1,4,3,8,68,0.037128,0.00815,0.000695
371830537112020,2,3,4,9,156,0.836096,0.012746,0.000229
371830505002012,1,4,2,7,27,0.355209,0.006789,0.001157
371830525043042,1,4,4,9,10,0.551133,0.007505,0.00024
371830537252009,2,4,4,10,46,1.198436,0.0085,0.000147
371830540061008,2,4,5,11,1223,1.276552,0.002659,6.9e-05
371830525051001,1,3,4,8,51,0.437691,0.012254,0.000211
371830540131035,2,1,4,7,100,1.024009,0.076914,0.000488
371830515011020,2,4,4,10,433,0.851212,0.004153,0.000334
371830503002014,1,2,2,5,66,0.498194,0.022194,0.001137
371830537211020,3,5,5,13,31,1.720617,0,0
371830518002013,1,4,4,9,32,0.349874,0.006237,0.000524
371830540141077,3,5,5,13,104,1.657106,0,0
371830542091072,5,5,5,15,86,3.346937,0,0
371830537241071,2,4,4,10,94,1.074333,0.0085,0.000147
371830527073032,2,5,5,12,56,1.348276,0,0
371830508001001,1,4,2,7,66,0.208955,0.007435,0.00114
371830540134022,3,5,5,13,8,2.050952,0,0
371830523013004,2,1,5,8,430,1.043111,0.033889,7.2e-05
371830540081010,1,4,4,9,224,0.613488,0.003023,0.000139
371830537112004,2,4,4,10,56,1.26609,0.0085,0.000147
371830527041012,1,4,4,9,47,0.371983,0.004763,0.000215
371830520024006,2,4,3,9,37,0.697728,0.002108,0.000635
371830537181004,5,5,5,15,252,4.301231,0,0
371830516004011,1,4,3,8,42,0.167621,0.004548,0.000541
371830540181036,2,4,5,11,124,0.955801,0.002298,8.6e-05
371830504001021,1,4,3,8,67,0.475656,0.005561,0.000752
371830541062022,2,5,5,12,17,1.51982,0,0
371830540163000,1,1,4,6,228,0.468616,0.059635,0.000247
371830523011016,2,1,5,8,45,0.831548,0.033889,7.2e-05
371830518001027,2,4,3,9,11,0.795816,0.009899,0.000897
371830526021015,2,4,4,10,57,0.773476,0.005234,0.000171
371830512002020,1,2,3,6,43,0.1877,0.023205,0.000709
371830536101008,3,5,5,13,168,2.155865,0,0
371830536101065,1,4,4,9,48,0.598229,0.001964,0.000197
371830540131022,2,1,4,7,47,1.183117,0.076914,0.000488
371830508002007,1,4,2,7,68,0.272215,0.010189,0.001238
371830541042032,2,1,4,7,51,0.67739,0.03317,0.0002
371830524011065,3,5,5,13,89,2.264339,0,0
371830512003002,1,4,3,8,56,0.066994,0.007111,0.000624
371830519001022,1,4,3,8,37,0.316816,0.006812,0.000869
371830525072023,3,5,5,13,55,1.791752,0,0
371830527012019,2,4,4,10,19,1.039212,0.005039,0.00023
371830528064029,2,4,4,10,74,0.636102,0.010303,0.000189
371830503001032,1,4,2,7,15,0.236751,0.008086,0.001354
371830525071003,2,3,3,8,43,1.182348,0.013421,0.000543
371830523023004,2,4,4,10,62,0.727447,0.00545,0.000141
371830536101082,3,5,5,13,124,1.984094,0,0
371830541043006,3,5,5,13,145,1.625944,0,0
371830536102039,1,4,4,9,347,0.225031,0.001964,0.000197
371830528063008,2,3,4,9,4,1.279848,0.016556,0.000185
371830540111010,2,5,5,12,174,1.524425,0,0
371830537073008,1,4,4,9,62,0.366783,0.011397,0.000372
371830537251001,2,4,4,10,306,0.96887,0.0085,0.000147
371830528064060,3,5,5,13,190,1.830141,0,0
371830516002007,2,4,4,10,66,0.993523,0.00255,0.000131
371830530081052,3,5,5,13,66,1.607211,0,0
371830524041020,1,1,5,7,17,0.319865,0.033889,7.2e-05
371830503001010,1,4,3,8,40,0.038411,0.007389,0.000745
371830512003000,1,4,3,8,67,0.032662,0.0067,0.000533
371830537132007,2,4,5,11,206,0.675284,0.004246,8.2e-05
371830518003001,1,4,4,9,37,0.082422,0.004919,0.000462
371830503001027,1,4,3,8,94,0.118855,0.006861,0.000633
371830537111024,3,5,5,13,79,1.754517,0,0
371830537093024,3,5,5,13,54,2.088885,0,0
371830537252041,3,5,5,13,85,1.767649,0,0
371830541063025,2,3,4,9,47,0.918092,0.016556,0.000185
371830537151000,1,3,4,8,400,0.612668,0.015425,0.000472
371830537111016,3,5,5,13,130,1.733119,0,0
371830516002015,1,4,4,9,46,0.306983,0.004334,0.00048
371830540083004,2,5,5,12,160,1.354279,0,0
371830506002006,1,4,2,7,75,0.251074,0.006864,0.001116
371830507003018,1,4,2,7,4,0.183236,0.004141,0.000999
371830538083027,1,4,4,9,82,0.492205,0.002632,0.000288
371830537093044,4,5,5,14,11,2.82599,0,0
371830526011003,2,3,4,9,104,0.90962,0.018318,0.000465
371830518003009,1,4,4,9,243,0.372842,0.004919,0.000462
371830541042018,1,1,4,6,104,0.347568,0.03317,0.0002
371830516005019,1,4,3,8,159,0.268133,0.006861,0.000633
371830545003010,2,5,5,12,110,1.379475,0,0
371830537131013,2,4,4,10,7,0.99928,0.002435,0.000119
371830507003042,1,4,3,8,19,0.429299,0.004709,0.000728
371830526032012,1,4,3,8,78,0.449004,0.008856,0.000655
371830537262017,2,4,4,10,125,0.936252,0.002435,0.000119
371830542081124,3,5,5,13,38,1.601212,0,0
371830536101024,3,5,5,13,25,1.865708,0,0
371830527043020,2,4,4,10,184,0.685359,0.004763,0.000215
370630019002070,5,5,5,15,83,4.805425,0,0
371830537121018,1,4,5,10,52,0.152379,0.004246,8.2e-05
371830519001009,1,4,3,8,75,0.423743,0.005104,0.000535
371830537092007,3,5,5,13,62,1.608794,0,0
371830521012013,1,4,4,9,57,0.292132,0.009606,0.000363
371830514005004,1,4,3,8,156,0.161968,0.006832,0.000633
371830525061014,1,3,3,7,37,0.234185,0.013421,0.000543
371830527012034,2,5,5,12,200,1.361209,0,0
371830541103024,5,5,5,15,224,4.56657,0,0
371830518001037,1,4,4,9,54,0.365916,0.003177,0.000397
371830526032013,2,4,3,9,34,0.674764,0.008856,0.000655
371830541052027,2,5,5,12,251,1.497979,0,0
371830519001040,1,4,3,8,47,0.325818,0.005027,0.000586
371830527012025,2,4,4,10,47,1.061091,0.005039,0.00023
371830537241082,2,5,5,12,23,1.502508,0,0
371830526022005,2,4,4,10,753,0.704292,0.002575,0.000102
371830537171010,3,5,5,13,107,2.046724,0,0
371830537092019,2,4,4,10,111,1.175313,0.002435,0.000119
371830528033027,3,5,5,13,10,1.569949,0,0
371830540043011,2,4,4,10,46,1.0619,0.007237,0.000104
371830540132021,2,4,4,10,51,0.98645,0.002632,0.000288
371830526022003,1,4,4,9,150,0.425564,0.002575,0.000102
371830507001002,1,4,1,6,2,0.149578,0.005226,0.001752
371830545001033,1,3,3,7,90,0.543543,0.019889,0.000608
371830525072016,2,4,4,10,49,1.088832,0.002435,0.000119
371830516004002,1,4,4,9,104,0.475754,0.00333,0.000361
371830517001021,1,4,4,9,3,0.112646,0.004919,0.000462
371830545003012,3,5,5,13,89,1.627276,0,0
371830537073003,1,4,4,9,367,0.341697,0.01112,0.000205
371830528033028,2,4,4,10,78,0.972277,0.001325,0.00015
371830542071058,4,5,5,14,122,3.295641,0,0
371830528033010,3,5,5,13,80,1.852542,0,0
371830525061010,2,5,5,12,64,1.453471,0,0
371830542071042,3,5,5,13,22,1.827701,0,0
371830524041028,1,1,4,6,4,0.44665,0.035608,0.000257
371830527012007,2,5,5,12,64,1.433209,0,0
371830528062041,3,5,5,13,29,2.214444,0,0
371830525031018,2,4,5,11,15,1.106775,0.004523,9.4e-05
371830538071011,2,4,4,10,78,0.691509,0.010065,0.000201
371830527073001,2,4,4,10,92,0.693654,0.011337,0.000103
371830503002016,1,2,2,5,113,0.470813,0.022178,0.000997
371830524043003,1,1,4,6,19,0.33331,0.036848,0.0004
371830526031015,1,3,3,7,45,0.369176,0.012124,0.000955
371830526021023,2,4,4,10,33,0.758656,0.005234,0.000171
371830537121016,1,4,5,10,39,0.184292,0.004246,8.2e-05
371830518002005,1,4,4,9,10,0.267174,0.004919,0.000462
371830524061008,2,1,4,7,277,0.899415,0.035672,0.00032
371830537231006,2,4,4,10,50,0.93123,0.010065,0.000331
371830537222004,2,4,4,10,43,0.785666,0.010065,0.000331
371830505002004,1,4,3,8,24,0.319201,0.005311,0.000719
371830537113005,2,3,4,9,443,0.667435,0.012746,0.000229
371830521014031,1,3,3,7,89,0.309109,0.014794,0.000604
371830528062032,3,5,5,13,143,1.900236,0,0
371830540171058,2,5,5,12,67,1.491662,0,0
371830525031015,2,4,5,11,274,1.082672,0.004523,9.4e-05
371830540083006,2,4,4,10,126,1.040519,0.003023,0.000139
371830537211029,3,5,5,13,3,2.210582,0,0
371830528072012,2,4,4,10,15,0.859731,0.010303,0.000189
371830541054010,1,4,4,9,13,0.573943,0.011337,0.000103
371830523023025,2,4,4,10,146,1.004484,0.00545,0.000141
371830540012017,1,4,5,10,106,0.519721,0.002659,6.9e-05
371830545002089,2,4,4,10,119,0.635509,0.00545,0.000141
371830540141089,2,5,5,12,271,1.410908,0,0
371830540171014,3,5,5,13,39,1.59286,0,0
371830521021027,1,4,4,9,38,0.182863,0.004318,0.000372
371830540131042,2,1,4,7,173,1.191161,0.076914,0.000488
371830526011002,2,3,4,9,57,0.927942,0.018318,0.000465
371830527073010,2,4,4,10,230,0.688375,0.011337,0.000103
371830540131003,2,4,4,10,46,1.186544,0.002632,0.000288
371830540131038,2,1,4,7,22,1.140297,0.076914,0.000488
371830526021020,2,4,4,10,60,0.83346,0.005234,0.000171
371830537111004,3,5,5,13,34,1.878037,0,0
371830545002081,2,4,1,7,122,0.905762,0.009058,0.002393
371830509001016,1,2,1,4,710,0.155272,0.027283,0.001904
371830524041003,1,1,4,6,73,0.310674,0.036848,0.0004
371830527063006,3,5,5,13,116,2.118108,0,0
371830540132004,2,4,4,10,41,0.679158,0.002632,0.000288
371830537143006,2,5,5,12,108,1.320574,0,0
371830525042007,1,4,4,9,99,0.622935,0.007505,0.00024
371830507003027,1,4,2,7,25,0.197725,0.007465,0.001364
371830515012037,1,5,5,11,37,0.547356,0.001038,7e-05
371830501001048,1,4,1,6,3,0.078931,0.005784,0.001968
371830541102054,5,5,5,15,1,3.780735,0,0
371830505001025,1,4,2,7,129,0.312156,0.006579,0.001119
371830537093045,4,5,5,14,41,2.897168,0,0
371830528064006,2,4,4,10,535,1.241098,0.010303,0.000189
371830541102046,2,1,4,7,51,1.014617,0.03317,0.0002
371830527051006,1,4,4,9,128,0.421681,0.004763,0.000215
371830509003012,1,2,1,4,35,0.025472,0.026774,0.001714
371830537091006,2,5,5,12,85,1.506276,0,0
371830540141037,2,4,4,10,371,1.089451,0.001332,0.00017
371830520012020,2,4,3,9,1,0.655199,0.003163,0.000883
371830511023000,1,2,3,6,96,0.233156,0.023205,0.000709
371830540132031,2,4,4,10,37,1.20825,0.002632,0.000288
371830540132047,3,5,5,13,49,1.681228,0,0
371830541051035,3,5,5,13,75,1.849723,0,0
371830518002010,1,4,4,9,46,0.25038,0.004919,0.000462
371830509002021,1,3,2,6,85,0.267561,0.016743,0.001311
371830530081062,2,1,5,8,175,1.207975,0.033889,7.2e-05
371830507001003,1,4,1,6,30,0.054301,0.005587,0.001794
371830527011011,1,4,4,9,29,0.08301,0.002575,0.000102
371830537232010,1,5,4,10,43,0.552321,0,0.00013
371830525051017,1,4,5,10,85,0.240934,0.011085,7.7e-05
371830508003000,1,4,2,7,27,0.219219,0.007447,0.001199
371830537121003,2,4,5,11,33,1.03413,0.004246,8.2e-05
371830527072018,2,3,4,9,31,1.145768,0.013802,0.000231
371830504001024,1,4,3,8,49,0.524232,0.005523,0.000687
371830540121001,2,4,4,10,128,1.040168,0.007237,0.000104
371830541102030,5,5,5,15,13,3.474994,0,0
371830514003004,1,4,3,8,94,0.502631,0.004638,0.000573
371830507003020,1,4,2,7,47,0.186586,0.005177,0.001254
371830526011021,2,4,4,10,50,0.639286,0.004062,0.000127
371830527051003,1,4,4,9,20,0.558085,0.004763,0.000215
371830528033030,2,4,4,10,7,0.826541,0.002514,0.000107
371830528033001,3,5,5,13,136,2.046952,0,0
371830537072009,2,5,4,11,106,0.777339,0.001169,0.000264
371830514002006,1,4,3,8,30,0.315237,0.006832,0.000633
371830506003002,1,4,1,6,44,0.194968,0.005143,0.001659
371830518002026,1,4,4,9,41,0.119318,0.006237,0.000524
371830540141088,3,5,5,13,96,1.828428,0,0
371830525031014,2,5,5,12,179,1.410859,0,0
371830535211001,4,5,5,14,3,2.969243,0,0
371830530081003,3,5,5,13,166,1.831169,0,0
371830501001098,1,4,1,6,6,0.091167,0.007915,0.001926
371830541062034,2,4,4,10,42,0.843306,0.006846,0.000189
371830521011002,2,4,4,10,253,0.6938,0.009606,0.000363
371830542071039,3,5,5,13,241,2.14377,0,0
371830520011013,2,4,4,10,62,1.013705,0.006846,0.000189
371830511013000,1,4,4,9,279,0.485908,0.002044,0.000235
371830537093039,4,5,5,14,32,3.321005,0,0
371830538082003,3,5,5,13,210,1.606349,0,0
371830537192003,5,5,5,15,256,4.352221,0,0
371830510001007,1,3,3,7,117,0.373204,0.021718,0.000727
371830537261012,2,4,4,10,683,0.763091,0.002435,0.000119
371830519003001,2,4,4,10,106,0.71327,0.005013,0.000387
371830540123005,2,4,4,10,15,0.905898,0.007237,0.000104
371830530082003,2,4,4,10,1,0.92695,0.00545,0.000141
371830528064000,3,5,5,13,137,1.716166,0,0
371830525051007,2,4,4,10,7,0.749911,0.007136,0.00048
371830541131021,5,5,5,15,83,4.518988,0,0
371830537152010,2,5,4,11,94,0.988974,0.001169,0.000134
371830537072012,1,3,4,8,1,0.427538,0.015425,0.000472
371830523011001,1,1,4,6,462,0.411565,0.034432,0.000176
371830521021028,1,4,4,9,129,0.332311,0.004318,0.000372
371830537241031,2,4,4,10,36,1.002035,0.0085,0.000147
371830541053009,4,5,5,14,36,2.551182,0,0
371830506001004,1,4,2,7,127,0.294345,0.007294,0.000994
371830512003022,1,4,3,8,34,0.052541,0.0067,0.000597
371830540151039,1,4,4,9,36,0.30706,0.003023,0.000139
371830541042030,2,1,4,7,35,1.167542,0.03317,0.0002
371830537163000,2,3,3,8,166,0.75905,0.018119,0.000669
371830542091079,4,5,5,14,64,3.126599,0,0
371830506003010,1,4,1,6,45,0.104269,0.006261,0.001819
371830540134001,3,5,5,13,44,1.883845,0,0
371830519001018,2,5,4,11,23,1.001872,0.000694,0.000175
371830524043004,1,1,4,6,56,0.432999,0.035608,0.000257
371830525051003,1,4,4,9,61,0.471713,0.004153,0.000334
371830540131017,2,1,4,7,67,1.201189,0.076914,0.000488
371830537143002,2,4,5,11,237,1.080758,0.004246,8.2e-05
371830504002002,1,4,2,7,74,0.100362,0.004189,0.001071
371830541054007,1,4,4,9,52,0.14,0.011337,0.000103
371830540123006,2,4,4,10,34,0.798247,0.007237,0.000104
371830511012017,2,4,4,10,68,0.704028,0.003827,0.000483
371830524011000,4,5,5,14,9,2.916217,0,0
371830519001006,2,4,4,10,26,1.267046,0.001452,0.000301
371830501001053,1,4,1,6,31,0.009577,0.005784,0.001968
371830516004005,2,4,4,10,100,0.765717,0.00255,0.000131
371830541042019,1,1,4,6,24,0.483682,0.03317,0.0002
371830540072000,3,5,5,13,68,1.701531,0,0
371830524062033,2,5,5,12,8,1.324215,0,0
371830525061012,2,5,5,12,124,1.384116,0,0
371830517003016,2,4,4,10,62,1.052699,0.008373,0.000528
371830524071006,2,4,4,10,78,1.118338,0.00209,0.000246
371830540141074,2,5,5,12,97,1.456664,0,0
371830523023007,2,4,4,10,50,0.948482,0.00545,0.000141
371830537241072,2,4,4,10,78,1.241829,0.0085,0.000147
371830540141023,2,4,4,10,203,1.246725,0.001332,0.00017
371830527051028,2,4,4,10,5,1.135791,0.002464,0.000129
371830530082001,2,4,4,10,9,1.283429,0.00545,0.000141
371830537241086,3,5,5,13,344,1.859143,0,0
371830511023003,1,3,4,8,15,0.076955,0.019789,0.000403
371830545001011,1,2,2,5,9,0.275276,0.021876,0.001001
371830537181007,5,5,5,15,70,3.463785,0,0
371830524011046,4,5,5,14,73,2.710184,0,0
371830541042027,1,1,4,6,193,0,0.03317,0.0002
371830537181003,5,5,5,15,58,3.715436,0,0
371830540171021,2,5,5,12,49,1.316186,0,0
371830524093003,1,5,4,10,126,0.136222,0.001195,0.000132
371830524081011,1,4,4,9,159,0.245802,0.002044,0.000235
371830525052004,2,5,5,12,52,1.471962,0,0
371830528033018,3,5,5,13,16,1.636605,0,0
371830528064026,2,4,4,10,109,0.952891,0.010303,0.000189
371830540061001,3,5,5,13,169,1.565193,0,0
371830507003012,1,4,3,8,16,0.175905,0.003462,0.000841
371830527073029,2,5,5,12,8,1.379814,0,0
371830519001011,2,4,4,10,23,0.72968,0.001473,0.000378
371830541041037,2,5,5,12,51,1.481121,0,0
371830523013003,2,5,5,12,45,1.33834,0,0
371830540151023,2,5,5,12,208,1.484791,0,0
371830540181005,2,4,4,10,16,0.640227,0.007237,0.000104
371830526011001,2,3,4,9,88,1.087641,0.015147,0.000204
371830540042004,2,4,4,10,102,0.67423,0.009896,0.000173
371830512003001,1,4,3,8,59,0.050961,0.007738,0.000603
371830537232001,2,5,4,11,5,0.738457,0,0.00013
371830541041041,2,1,4,7,97,0.759197,0.03317,0.0002
371830524011007,3,5,5,13,2,1.811044,0,0
371830541102013,5,5,5,15,224,3.458687,0,0
371830540141062,2,4,4,10,131,0.950359,0.001332,0.00017
371830541052019,2,4,4,10,53,1.212995,0.011337,0.000103
371830545001017,1,3,3,7,47,0.051548,0.021632,0.000878
371830540134021,2,5,5,12,56,1.520403,0,0
371830537191007,5,5,5,15,59,3.904666,0,0
371830537222009,2,5,5,12,48,1.315934,0,0
371830518002009,1,4,4,9,78,0.141135,0.004919,0.000462
371830507001012,1,2,1,4,3,0.053101,0.026698,0.001884
371830525031006,3,5,5,13,6,1.994687,0,0
371830537073007,1,3,3,7,25,0.520199,0.01546,0.0006
371830540041001,2,4,4,10,46,0.654572,0.009896,0.000173
371830514005017,1,4,3,8,129,0.103071,0.00815,0.000695
371830516004014,1,4,3,8,69,0.190969,0.005007,0.000651
371830527043016,1,4,4,9,110,0.356106,0.004763,0.000215
371830540141054,3,5,5,13,8,1.720959,0,0
371830542091049,5,5,5,15,145,3.717647,0,0
371830516001007,2,4,3,9,24,0.835644,0.007682,0.000797
371830540071004,2,5,5,12,109,1.507211,0,0
371830541101013,4,5,5,14,10,3.010079,0,0
371830527052007,1,4,4,9,5,0.317551,0.004763,0.000215
371830541055012,2,4,4,10,6,1.190401,0.011337,0.000103
371830506001009,1,4,3,8,18,0.110596,0.006526,0.000871
371830540171051,2,5,5,12,10,1.391073,0,0
371830523021009,2,5,5,12,713,0.723472,1.9e-05,5.2e-05
371830525033004,3,5,5,13,16,1.720244,0,0
371830527073038,3,5,5,13,33,1.638066,0,0
371830528072081,2,4,4,10,35,1.002899,0.010303,0.000189
371830528072027,2,4,4,10,63,0.956307,0.010303,0.000189
371830537221007,2,5,5,12,106,1.30156,0,0
371830541052016,2,5,5,12,823,1.498652,0,0
371830528064056,3,5,5,13,26,1.987127,0,0
371830537072004,2,5,4,11,137,0.723658,0.001204,0.000392
371830541102050,5,5,5,15,185,3.78822,0,0
371830527051013,1,4,4,9,18,0.289238,0.002464,0.000129
371830503002003,1,4,3,8,106,0.279942,0.007506,0.000926
371830524063016,3,5,5,13,19,2.130188,0,0
371830512002007,1,4,3,8,109,0.017608,0.007227,0.000708
371830537113000,1,3,4,8,43,0.372907,0.012746,0.000229
371830541042021,1,1,4,6,43,0.381083,0.03317,0.0002
371830540141070,2,4,4,10,6,1.200963,0.001332,0.00017
371830526031003,1,4,4,9,52,0.559712,0.004153,0.000334
371830541102000,4,5,5,14,1154,3.319907,0,0
371830515012017,2,4,3,9,51,0.807728,0.00533,0.000602
371830517003009,2,4,4,10,54,0.913049,0.008373,0.000528
371830507002004,1,4,1,6,42,0.168243,0.004862,0.001556
371830527051021,2,4,4,10,78,0.952142,0.004763,0.000215
371830541061009,3,5,5,13,89,2.050574,0,0
371830523012002,1,1,4,6,60,0.203373,0.035608,0.000257
370630019002098,5,5,5,15,112,4.015112,0,0
371830537112006,2,3,4,9,66,0.815249,0.012746,0.000229
371830514002007,1,4,3,8,88,0.272259,0.007681,0.000735
371830527051018,2,4,4,10,88,0.794123,0.002464,0.000129
371830541052001,2,5,5,12,2,1.392199,0,0
371830510001016,1,3,3,7,13,0.587706,0.021729,0.00094
371830540013007,1,4,4,9,44,0.322852,0.005553,0.000163
371830518001021,1,4,4,9,30,0.311582,0.004919,0.000462
371830524011060,2,5,5,12,2,1.368341,0,0
371830527011014,1,4,4,9,71,0.346101,0.002575,0.000102
371830530081046,2,5,5,12,84,1.393917,0,0
371830527063007,3,5,5,13,13,1.752568,0,0
371830541041036,2,5,5,12,153,1.35404,0,0
371830526021021,2,4,4,10,36,0.722655,0.005234,0.000171
371830518002001,1,4,4,9,65,0.18002,0.004919,0.000462
371830504001020,1,4,3,8,378,0.148656,0.001968,0.000659
371830545002032,1,4,1,6,8,0.444678,0.009058,0.002393
371830528064002,3,5,5,13,46,2.137194,0,0
371830541051000,3,5,5,13,105,2.086984,0,0
371830540151041,1,4,4,9,3,0.496191,0.003023,0.000139
371830545003023,2,5,5,12,163,1.415013,0,0
371830523021010,2,5,5,12,47,1.02756,1.9e-05,5.2e-05
371830525033025,2,4,5,11,95,0.799038,0.004523,9.4e-05
371830527062001,3,5,5,13,36,1.727244,0,0
371830528071007,2,4,4,10,11,1.062587,0.010303,0.000189
371830506001005,1,4,3,8,103,0.12726,0.006516,0.000791
371830540161013,2,1,4,7,32,1.050105,0.059635,0.000247
371830525043014,1,4,4,9,2,0.197265,0.007505,0.00024
371830517001008,1,4,4,9,45,0.18915,0.004919,0.000462
371830537092015,2,5,5,12,33,1.424638,0,0
371830512003015,1,4,3,8,14,0.156887,0.007111,0.000624
371830515012029,1,5,5,11,43,0.524225,0.001038,7e-05
371830510002020,1,2,2,5,35,0.251193,0.024164,0.001052
371830541054004,1,4,4,9,683,0.604369,0.011337,0.000103
371830527011005,1,4,4,9,20,0.311437,0.002575,0.000102
371830523022008,1,3,4,8,30,0.322343,0.021712,0.000194
371830541102038,5,5,5,15,47,3.911418,0,0
371830523013008,3,5,5,13,34,1.558949,0,0
371830528072078,2,4,4,10,75,0.784307,0.010303,0.000189
371830537191013,5,5,5,15,82,3.96111,0,0
371830525043038,2,4,4,10,21,0.72747,0.007505,0.00024
371830545001042,1,3,3,7,12,0.298037,0.019889,0.000608
371830541053025,4,5,5,14,108,2.560685,0,0
371830540161008,2,1,4,7,48,0.67833,0.059635,0.000247
371830525061009,2,5,5,12,51,1.397464,0,0
371830540141013,2,5,5,12,10,1.379183,0,0
371830537241016,3,5,5,13,169,1.950011,0,0
371830537091008,4,5,5,14,313,2.802827,0,0
371830541044013,2,4,4,10,335,1.218889,0.011337,0.000103
371830541053022,4,5,5,14,100,2.667994,0,0
371830537092023,2,4,4,10,118,1.229413,0.002435,0.000119
371830537232013,1,5,4,10,26,0.218676,0.001204,0.000392
371830537252025,3,5,5,13,38,1.804829,0,0
371830540132044,3,5,5,13,52,1.56179,0,0
371830537093036,4,5,5,14,21,2.565349,0,0
371830525072009,2,5,5,12,78,1.436629,0,0
371830540012012,2,4,4,10,86,0.977885,0.005234,0.000171
371830527073006,2,4,4,10,30,1.114791,0.011337,0.000103
371830541051046,3,5,5,13,1,1.862719,0,0
371830528064061,2,4,4,10,99,0.941216,0.010303,0.000189
371830501001094,1,2,1,4,2,0.056044,0.023533,0.001941
371830536101069,1,4,4,9,37,0.436532,0.001964,0.000197
371830528062052,3,5,5,13,541,2.033867,0,0
371830509001011,1,2,2,5,62,0.233611,0.025035,0.001346
371830528072083,1,4,4,9,55,0.539344,0.010303,0.000189
371830525031019,2,4,5,11,13,1.241501,0.004523,9.4e-05
371830516001004,2,4,4,10,30,1.18134,0.00255,0.000131
371830521021006,2,4,4,10,158,0.93586,0.006846,0.000189
371830525072013,3,5,5,13,502,1.711939,0,0
371830537252024,3,5,5,13,70,1.786344,0,0
371830541043026,3,5,5,13,147,1.755395,0,0
371830537232007,2,5,4,11,2,1.104849,3.5e-05,0.000258
371830545003033,2,5,5,12,4,1.471462,0,0
371830537163004,1,3,4,8,99,0.465839,0.016638,0.00024
371830537251020,2,3,4,9,2,1.063329,0.012746,0.000229
371830540042002,2,4,4,10,148,0.716376,0.007237,0.000104
371830525032019,1,4,5,10,81,0.617634,0.004523,9.4e-05
371830520021006,1,4,4,9,155,0.207424,0.006846,0.000189
371830521021011,2,5,4,11,110,1.021933,0.000247,0.000338
371830527012008,2,5,5,12,6,1.369272,0,0
371830527061011,2,5,5,12,35,1.302666,0,0
371830527073024,2,5,5,12,486,1.377783,0,0
371830505002005,1,4,3,8,6,0.621603,0.005523,0.000687
371830509001015,1,2,1,4,1,0.264131,0.026667,0.001713
371830540081002,1,4,4,9,8,0.416522,0.003023,0.000139
371830540013001,2,4,5,11,395,1.064885,0.002659,6.9e-05
371830525042008,2,4,4,10,93,0.977354,0.007505,0.00024
371830540163015,2,5,5,12,63,1.366,0,0
371830514002005,1,4,3,8,66,0.167509,0.006832,0.000633
371830541054011,2,4,4,10,419,0.803668,0.011337,0.000103
371830537092017,2,5,5,12,87,1.486429,0,0
371830541041033,2,1,4,7,5,1.142709,0.03317,0.0002
371830514003015,2,4,3,9,61,0.728192,0.00453,0.000606
371830540141053,3,5,5,13,14,1.699101,0,0
370630019002099,5,5,5,15,60,3.897438,0,0
371830508002014,1,3,2,6,1,0.243151,0.013599,0.001036
371830536102033,1,4,4,9,31,0.291019,0.001964,0.000197
371830507003017,1,4,2,7,20,0.214276,0.004147,0.001057
371830541054017,1,4,4,9,16,0.44702,0.011337,0.000103
371830537171026,4,5,5,14,104,3.233992,0,0
371830517002000,2,4,4,10,212,0.976009,0.005353,0.000502
371830527061021,3,5,5,13,9,1.617787,0,0
371830528063012,3,5,5,13,109,1.920602,0,0
371830542071097,3,5,5,13,17,2.087053,0,0
371830524011054,3,5,5,13,5,1.734148,0,0
371830537071000,2,5,4,11,179,0.818918,0.001169,0.000264
371830537241068,3,5,5,13,42,1.664113,0,0
371830540134040,3,5,5,13,52,1.836442,0,0
371830524062004,3,5,5,13,2,1.71159,0,0
371830510002011,1,2,2,5,30,0.254347,0.026086,0.001177
371830523013005,2,1,5,8,97,1.076004,0.033889,7.2e-05
371830527052004,1,4,4,9,111,0.308691,0.004763,0.000215
371830508002010,1,3,2,6,162,0.30633,0.013367,0.001031
371830515011029,2,4,4,10,20,0.879686,0.004112,0.000423
371830510002031,1,2,2,5,81,0.179413,0.025035,0.001346
371830507001017,1,4,1,6,12,0.15628,0.007747,0.001657
371830537111001,3,5,5,13,6,1.58405,0,0
371830540132014,2,5,5,12,72,1.307212,0,0
371830518001034,1,4,4,9,46,0.331193,0.004864,0.000518
371830541051008,3,5,5,13,18,2.130498,0,0
371830527012036,2,5,5,12,36,1.46118,0,0
371830540122002,2,4,4,10,62,0.970574,0.007237,0.000104
371830515012005,2,4,3,9,27,0.842137,0.00533,0.000602
371830537251025,2,4,4,10,72,0.939499,0.006681,0.0002
371830525043041,2,4,4,10,19,0.681989,0.007505,0.00024
371830540141019,2,5,5,12,86,1.34828,0,0
371830541102039,5,5,5,15,149,4.129675,0,0
371830541043009,3,5,5,13,31,1.602399,0,0
371830505003019,1,4,4,9,231,0.400844,0.00498,0.000435
371830537111034,1,4,5,10,35,0.622042,0.004246,8.2e-05
371830545004017,2,4,4,10,2,1.2045,0.00545,0.000141
371830527012037,2,5,5,12,43,1.369507,0,0
371830541061001,2,3,4,9,185,1.082589,0.016556,0.000185
371830541061015,3,5,5,13,3,2.219412,0,0
371830525033018,2,4,5,11,58,0.875028,0.004523,9.4e-05
371830527013012,1,4,4,9,11,0.341273,0.004103,0.000228
371830503001028,1,4,2,7,1,0.224733,0.007342,0.00126
371830537111006,3,5,5,13,15,1.949262,0,0
371830540171012,3,5,5,13,1,1.56619,0,0
371830540081014,1,4,4,9,32,0.288833,0.003023,0.000139
371830536101074,2,5,5,12,44,1.485775,0,0
371830537093020,3,5,5,13,29,2.206044,0,0
371830541132039,3,5,5,13,27,2.419904,0,0
371830524011041,4,5,5,14,657,2.678646,0,0
371830540132015,2,4,4,10,28,1.231869,0.002632,0.000288
371830545003007,2,5,5,12,56,1.438625,0,0
371830526021019,2,4,4,10,66,0.78717,0.005234,0.000171
371830540012016,2,4,4,10,29,0.923479,0.005234,0.000171
371830521021002,2,4,4,10,433,0.77967,0.006846,0.000189
371830537091010,3,5,5,13,39,1.64176,0,0
371830504001035,1,4,2,7,46,0.004794,0.006296,0.000981
371830524071015,2,4,4,10,91,0.994842,0.002632,0.00035
371830542071028,4,5,5,14,15,2.621301,0,0
371830504002007,1,4,2,7,84,0.037618,0.006321,0.0011
371830541041038,2,5,5,12,52,1.348024,0,0
371830527061026,2,4,4,10,79,0.873775,0.002464,0.000129
371830537232015,2,5,4,11,284,1.048499,3.5e-05,0.000128
371830537071002,2,5,4,11,79,0.762397,0.001169,0.000264
371830527011001,2,4,4,10,83,0.703039,0.005234,0.000171
371830507003033,1,4,2,7,27,0.31326,0.008484,0.001375
371830523013007,2,5,5,12,25,1.449205,0,0
371830521013005,1,4,4,9,824,0.007384,0.009606,0.000363
371830537121012,1,4,5,10,5,0.054276,0.004246,8.2e-05
371830503002018,1,2,2,5,2,0.374891,0.022194,0.001137
371830507003038,1,4,2,7,25,0.172046,0.008234,0.001196
371830523013012,2,1,5,8,12,1.046337,0.033889,7.2e-05
371830537251004,1,3,4,8,2,0.430664,0.012746,0.000229
371830541063002,2,5,5,12,81,1.428086,0,0
371830521013000,2,4,4,10,230,0.842593,0.010476,0.000232
371830540141025,1,4,4,9,24,0.591349,0.001332,0.00017
371830514005021,1,4,3,8,40,0.148374,0.00815,0.000695
371830505003011,1,4,4,9,24,0.283319,0.004903,0.000271
371830528064030,3,5,5,13,159,1.604477,0,0
371830523011008,1,1,5,7,156,0.410569,0.033889,7.2e-05
371830524011067,4,5,5,14,2,2.501077,0,0
371830537251024,2,5,5,12,43,1.448572,0,0
371830524071007,2,4,4,10,39,0.844938,0.001783,0.000248
371830524093010,1,1,4,6,28,0.473464,0.035084,0.000204
371830540043013,2,4,4,10,40,1.13377,0.007237,0.000104
371830524011044,3,5,5,13,18,2.209389,0,0
370630019002067,5,5,5,15,59,4.598437,0,0
371830542091047,5,5,5,15,46,3.370932,0,0
371830537224004,1,5,4,10,160,0.393989,0.001169,0.000264
371830511012012,2,4,4,10,123,0.682076,0.002044,0.000235
371830545004008,2,5,5,12,81,1.445199,0,0
371830505002008,1,4,4,9,56,0.353352,0.00498,0.000435
371839802001019,5,5,5,15,27,6.20171,0,0
371830526031008,1,3,3,7,15,0.297269,0.013126,0.000955
371830517003027,1,4,4,9,25,0.412058,0.004311,0.000401
371830536101073,3,5,5,13,547,1.944594,0,0
371830537223008,1,4,4,9,75,0.477746,0.010065,0.000201
371830541063010,1,3,4,8,72,0.107414,0.016556,0.000185
371830520022012,1,4,3,8,62,0.300588,0.001467,0.000655
371830514004016,2,4,3,9,20,0.835691,0.007351,0.000597
371830527061020,3,5,5,13,60,1.550948,0,0
371830526021002,2,4,4,10,79,0.680835,0.005234,0.000171
371830540161010,2,1,4,7,24,0.751557,0.059635,0.000247
371830540131026,2,5,5,12,9,1.359625,0,0
371830525032016,2,4,5,11,16,0.714976,0.004523,9.4e-05
371830537241004,4,5,5,14,611,2.48001,0,0
371830527051029,2,5,5,12,47,1.334434,0,0
371830507003039,1,4,2,7,70,0.2583,0.00781,0.001139
371830540143018,2,4,4,10,62,0.822975,0.001332,0.00017
371830540141029,2,4,4,10,141,0.946372,0.001332,0.00017
371830503001030,1,4,2,7,18,0.184327,0.007849,0.001054
371830528062014,2,4,4,10,1,1.109515,0.006846,0.000189
371830501001035,1,2,2,5,3,0.431162,0.022541,0.00125
371830525031011,2,5,5,12,287,1.532236,0,0
371830540163010,3,5,5,13,28,1.614553,0,0
371830521012007,1,4,4,9,38,0.018109,0.010931,0.000513
371830536101063,2,4,4,10,69,0.677347,0.001964,0.000197
371830510001013,1,3,3,7,107,0.624386,0.021729,0.00094
371830537092014,3,5,5,13,41,1.714874,0,0
371830515021003,2,4,4,10,205,0.88764,0.003517,0.000443
371830506003025,1,4,1,6,10,0.103009,0.005033,0.001592
371830526012009,2,4,4,10,39,0.695445,0.008373,0.000528
371830525043006,2,4,5,11,1,1.240852,0.004523,9.4e-05
371830528062006,2,5,5,12,8,1.438422,0,0
371830506002009,1,4,1,6,18,0.107191,0.009085,0.001526
371830537191009,5,5,5,15,29,3.981947,0,0
371830537071003,2,5,4,11,66,0.897853,0,0.00013
371830530082006,2,5,5,12,237,1.480421,0,0
371830528061026,3,5,5,13,70,1.878464,0,0
371830521021019,1,4,4,9,454,0.09851,0.003839,0.000257
371830537181018,5,5,5,15,124,3.753849,0,0
371830514001007,1,4,4,9,81,0.282708,0.003789,0.000471
371830511013001,1,4,4,9,12,0.450652,0.002044,0.000235
371830501001047,1,4,1,6,25,0.137501,0.005781,0.001967
371830510002004,1,2,2,5,40,0.30939,0.026004,0.001115
371830523011009,1,1,5,7,62,0.529499,0.033889,7.2e-05
371830537191004,5,5,5,15,49,3.878666,0,0
371830524011051,4,5,5,14,79,2.640658,0,0
371830537181000,5,5,5,15,826,3.852252,0,0
371830524071014,2,4,4,10,271,1.079199,0.002632,0.00035
371830517001006,1,4,4,9,134,0.392542,0.004919,0.000462
371830537192001,5,5,5,15,165,4.390813,0,0
371830521013004,2,4,4,10,206,1.036134,0.010476,0.000232
371830542071101,3,5,5,13,169,1.653723,0,0
371830524041014,1,1,4,6,56,0.352905,0.036848,0.0004
371830514003006,2,4,3,9,60,0.697085,0.004638,0.000573
371830536101086,2,5,5,12,48,1.330978,0,0
371830536101068,2,4,4,10,30,0.633688,0.001964,0.000197
371830537113015,2,3,4,9,161,0.969366,0.012746,0.000229
371830541062039,1,3,4,8,34,0.623641,0.016556,0.000185
371830516002012,1,5,5,11,23,0.602771,0.001038,7e-05
371830524081005,2,4,4,10,26,0.831478,0.003827,0.000483
371830537072017,1,3,3,7,17,0.122218,0.015425,0.000602
371830527011003,2,4,4,10,89,0.77568,0.002575,0.000102
371830511022010,1,3,4,8,403,0.150699,0.019978,0.000385
371830540171009,3,5,5,13,73,1.681759,0,0
371830521021015,2,5,4,11,49,1.126794,0.000247,0.000338
371830520021007,1,4,4,9,43,0.378379,0.006846,0.000189
371830524011004,4,5,5,14,76,3.220846,0,0
371830505002014,1,4,3,8,30,0.494951,0.005561,0.000752
371830523011000,1,1,4,6,118,0.11453,0.034432,0.000176
371830540163020,2,5,5,12,118,1.342817,0,0
371830523022006,2,4,4,10,116,0.755061,0.00545,0.000141
371830540131018,2,1,4,7,17,1.161325,0.076914,0.000488
371830540084001,2,4,4,10,22,1.073403,0.003023,0.000139
371830537162001,1,3,4,8,43,0.572648,0.016915,0.000407
371830537071012,2,5,4,11,14,1.013885,0,0.00013
371830519002002,2,4,5,11,2,0.69114,0.003562,8.6e-05
371830517001019,1,4,4,9,12,0.119321,0.004919,0.000462
371830540141016,2,5,5,12,133,1.393701,0,0
371830536102015,1,4,4,9,147,0.630169,0.001964,0.000197
371830542071040,3,5,5,13,70,2.150279,0,0
371830518002028,1,4,4,9,39,0.18208,0.004688,0.000458
371830505001011,1,4,2,7,43,0.177745,0.005865,0.000968
371830523013024,2,1,5,8,34,0.959761,0.033889,7.2e-05
371830537071015,2,5,5,12,386,1.435033,0,0
371830538082004,3,5,5,13,58,2.21291,0,0
371830520021001,1,4,4,9,127,0.545941,0.006846,0.000189
371830537232011,1,5,4,10,36,0.556561,0,0.00013
371830512003006,1,4,3,8,56,0.16077,0.0067,0.000533
371830525043016,1,4,4,9,29,0.342027,0.007505,0.00024
371830528064038,3,5,5,13,74,2.071076,0,0
371830524081016,1,4,4,9,110,0.337532,0.002587,0.000339
371830519001016,2,5,4,11,20,0.928967,0.000694,0.000175
371830525061003,1,3,3,7,63,0.578535,0.013421,0.000543
371830524043002,1,1,4,6,170,0.530087,0.036848,0.0004
371830542091043,4,5,5,14,49,3.327137,0,0
371830537162012,1,3,4,8,24,0.487848,0.018318,0.000465
371830540081013,2,4,4,10,97,0.707565,0.003023,0.000139
371830526021017,2,4,4,10,32,0.900593,0.005234,0.000171
371830506003001,1,4,1,6,37,0.102545,0.010022,0.001807
371830545003015,2,5,5,12,41,1.491326,0,0
371830540162014,2,1,4,7,43,1.183736,0.059635,0.000247
371830518001018,1,4,4,9,72,0.408777,0.006237,0.000524
371830540131031,2,1,4,7,141,0.963349,0.076914,0.000488
371830512001007,1,4,3,8,59,0.273913,0.006861,0.000633
371830540142005,1,4,4,9,181,0.197167,0.001332,0.00017
371830537131000,1,4,5,10,59,0.243922,0.004246,8.2e-05
371830506003009,1,4,1,6,37,0.112696,0.00561,0.001793
371830527043022,1,4,5,10,25,0.630372,0.002298,8.6e-05
371830530081029,2,1,5,8,123,1.14294,0.033889,7.2e-05
370630019002078,5,5,5,15,124,4.794949,0,0
371830542071045,4,5,5,14,254,2.777975,0,0
371830538071008,1,4,4,9,436,0.187911,0.010065,0.000201
371830525033022,2,5,5,12,15,1.357272,0,0
371830540142009,2,4,4,10,19,0.68885,0.001332,0.00017
371830540061007,3,5,5,13,81,1.601188,0,0
371830518001014,1,4,4,9,135,0.384289,0.004919,0.000462
371830538084020,2,2,3,7,41,0.661793,0.025679,0.000856
371830537181009,5,5,5,15,238,3.96907,0,0
371830526022007,1,4,4,9,30,0.390381,0.002575,0.000102
371830537121013,1,4,5,10,2,0.414377,0.004246,8.2e-05
371830515012008,1,4,3,8,29,0.498902,0.009853,0.000696
371830506003016,1,4,1,6,74,0.111235,0.006185,0.001655
371830514003008,1,4,3,8,68,0.624848,0.004665,0.000633
371830540171013,2,5,5,12,2,1.471374,0,0
371830512003004,1,4,3,8,39,0.056169,0.007111,0.000624
371830501001015,1,4,2,7,47,0.555524,0.003652,0.00134
371830537261013,1,4,4,9,232,0.600017,0.002435,0.000119
371830504001026,1,4,3,8,73,0.260387,0.005529,0.000745
371830527052003,1,4,4,9,56,0.208639,0.004763,0.000215
371830520021010,1,4,4,9,42,0.617618,0.006846,0.000189
371830542091067,4,5,5,14,82,3.181735,0,0
371830537241062,2,4,4,10,27,1.045447,0.0085,0.000147
371830540041007,1,4,4,9,27,0.268313,0.007237,0.000104
371830524041009,1,1,4,6,76,0.351987,0.036848,0.0004
371830507003015,1,4,2,7,39,0.261083,0.008272,0.001262
371830506002020,1,4,2,7,30,0.231435,0.006791,0.00106
371830528062025,2,4,4,10,182,0.804524,0.006846,0.000189
371830540012013,2,4,5,11,36,1.170668,0.002659,6.9e-05
371830518001009,2,4,4,10,77,0.848649,0.004919,0.000462
371830520011003,3,5,5,13,1455,1.557309,0,0
371830507003016,1,4,2,7,25,0.066357,0.004172,0.001175
371830545002047,3,5,5,13,3,1.65764,0,0
371830537162013,1,3,4,8,12,0.609921,0.018318,0.000465
371830537112027,1,4,5,10,17,0.107457,0.004246,8.2e-05
371830512003020,1,2,3,6,47,0.250879,0.022962,0.00065
371830537171042,3,5,5,13,81,2.064883,0,0
371830537072018,1,5,4,10,407,0.236781,3.5e-05,0.000128
371830542071100,3,5,5,13,87,1.747584,0,0
371830541101001,4,5,5,14,52,2.784754,0,0
371830537113002,1,3,4,8,282,0.093469,0.012746,0.000229
371830524043009,1,1,4,6,9,0.356154,0.035608,0.000257
371830541062008,1,3,4,8,62,0.583406,0.016556,0.000185
371830540131044,1,1,4,6,91,0.610875,0.076914,0.000488
371830527052019,1,4,4,9,45,0.469431,0.002464,0.000129
371830514002009,1,4,3,8,86,0.096221,0.00815,0.000695
371830540141011,3,5,5,13,83,1.849479,0,0
371830514005009,1,4,3,8,33,0.245986,0.00815,0.000695
371830541063011,2,3,4,9,64,0.7709,0.016556,0.000185
371830541053011,4,5,5,14,249,2.921107,0,0
371830541103012,5,5,5,15,105,3.963482,0,0
371830525072010,2,4,4,10,71,1.270628,0.002435,0.000119
371830528062053,3,5,5,13,1,1.685053,0,0
371830521021023,2,5,5,12,7,1.489516,0,0
371830525032001,2,4,5,11,270,1.271437,0.004523,9.4e-05
371830519003011,1,4,4,9,32,0.55325,0.00434,0.000289
371830542071077,4,5,5,14,6,2.684895,0,0
371830518001033,1,4,4,9,80,0.377018,0.003353,0.000457
371830537171006,3,5,5,13,184,2.184554,0,0
371830537071028,2,5,4,11,55,0.739883,0.001169,0.000134
371830540141039,2,5,5,12,91,1.43737,0,0
371830537241001,3,5,5,13,233,2.195958,0,0
371830528072019,1,4,4,9,8,0.32538,0.010303,0.000189
371830514001008,1,4,4,9,71,0.380747,0.003816,0.00053
371830524092004,1,4,4,9,378,0.591341,0.00324,0.000151
371830530091003,3,5,5,13,3,1.552097,0,0
371830528033037,2,4,4,10,96,0.996224,0.003839,0.000257
371830537121006,2,4,5,11,238,1.275702,0.004246,8.2e-05
371830541061002,3,5,5,13,31,1.621305,0,0
371830542091053,5,5,5,15,90,3.684665,0,0
371830540112009,3,5,5,13,88,1.538946,0,0
371830509002012,1,3,3,7,211,0.450123,0.021654,0.00095
371830510002008,1,2,1,4,29,0.111094,0.025559,0.001523
371830540072017,2,5,4,11,205,0.974444,3.5e-05,0.000128
371830536101067,1,4,4,9,48,0.47491,0.001964,0.000197
371830537132014,1,4,5,10,57,0.609895,0.004246,8.2e-05
371830525051025,1,4,4,9,136,0.433403,0.007136,0.00048
371830525051028,1,4,4,9,141,0.364399,0.007136,0.00048
371830509002017,1,2,2,5,42,0.147916,0.026654,0.0014
371830524041006,1,4,4,9,19,0.368417,0.003827,0.000483
371830521014026,1,3,3,7,31,0.494009,0.014794,0.000604
371830538071010,1,4,4,9,130,0.083788,0.010065,0.000201
371830501001041,1,4,1,6,2,0.153397,0.005339,0.001906
371830537093011,4,5,5,14,32,2.619926,0,0
371830540143033,3,5,5,13,200,1.630112,0,0
371830520024010,1,4,2,7,41,0.571425,0.004823,0.001013
371830521012001,1,3,3,7,57,0.569518,0.014794,0.000604
371830517003005,2,4,4,10,103,0.793289,0.004153,0.000334
371830519001010,1,4,3,8,44,0.451111,0.006812,0.000869
371830511022007,1,4,4,9,423,0.55375,0.003267,0.00021
371830514003011,1,4,3,8,42,0.62885,0.004665,0.000633
371830528072056,5,5,5,15,3,3.836194,0,0
371830525032012,2,4,5,11,38,0.836437,0.004523,9.4e-05
371830537251008,2,5,5,12,167,1.301131,0,0
371830541051017,3,5,5,13,75,2.092835,0,0
371830515022024,1,4,4,9,162,0.383479,0.00418,0.000402
371830540171035,2,4,4,10,93,1.27294,0.007237,0.000104
371830519003010,2,4,4,10,99,0.790794,0.00434,0.000289
371830542071035,4,5,5,14,40,2.523575,0,0
371830545001019,1,3,3,7,53,0.033855,0.021604,0.000788
371830537262015,2,4,4,10,364,0.837591,0.002435,0.000119
371830540012006,1,4,4,9,61,0.435411,0.005234,0.000171
371830541061043,2,3,4,9,38,1.163393,0.016556,0.000185
371830524063003,4,5,5,14,230,2.909523,0,0
371830525043031,1,4,4,9,128,0.616152,0.007505,0.00024
371830540041003,2,4,4,10,52,0.816876,0.009896,0.000173
371830506002032,1,4,1,6,23,0.041711,0.009329,0.001711
371830541042006,1,1,4,6,27,0.407213,0.03317,0.0002
371830515012016,1,4,4,9,263,0.57181,0.005239,0.000396
371830541063020,1,3,4,8,417,0.322239,0.016556,0.000185
371830540111009,2,5,5,12,196,1.343246,0,0
371830515011013,1,4,3,8,12,0.503956,0.008354,0.000659
371830540122003,1,4,4,9,49,0.48081,0.007237,0.000104
371830545003027,2,5,5,12,20,1.473033,0,0
371830541103001,5,5,5,15,57,3.958277,0,0
371830501001021,1,4,1,6,34,0.260482,0.006461,0.001721
371830510001006,1,2,3,6,125,0.517765,0.021807,0.000877
371830527011016,1,4,4,9,195,0.391146,0.002575,0.000102
371830540134038,3,5,5,13,147,1.946712,0,0
371830540181030,1,4,5,10,134,0.6167,0.002298,8.6e-05
371830537143011,2,5,4,11,3,1.273816,0.001169,0.000134
371830528064023,2,4,4,10,708,1.086962,0.010303,0.000189
371830515022005,1,4,4,9,43,0.296685,0.002668,0.000341
371830521014032,1,3,3,7,82,0.224261,0.014794,0.000604
371830525071002,2,3,3,8,66,0.969354,0.013421,0.000543
371830524062009,3,5,5,13,5,1.858239,0,0
371830528033011,3,5,5,13,38,1.89194,0,0
371830505003018,1,4,4,9,18,0.232555,0.004903,0.000271
371830540134028,3,5,5,13,24,1.734881,0,0
371830545002033,1,4,1,6,127,0.55826,0.008963,0.00222
371830506002007,1,4,2,7,11,0.117941,0.007427,0.001351
371830540163005,2,5,5,12,85,1.439481,0,0
371830542071038,3,5,5,13,52,1.907346,0,0
371830515022012,1,4,4,9,85,0.367235,0.002668,0.000341
371830525052006,2,4,4,10,22,1.161655,0.004153,0.000334
371830524011066,3,5,5,13,368,2.368043,0,0
371830501001043,1,4,1,6,2,0.322431,0.006461,0.001721
371830507003043,1,4,3,8,157,0.376397,0.004709,0.000728
371830530081038,2,1,5,8,196,1.214159,0.033889,7.2e-05
371830537141009,2,4,5,11,62,0.923423,0.004246,8.2e-05
371830519002013,1,4,3,8,43,0.524772,0.00604,0.000543
371830520012017,1,4,3,8,22,0.601461,0.00274,0.000826
371830537181025,5,5,5,15,166,4.00032,0,0
371830518001019,1,4,4,9,47,0.191931,0.006237,0.000524
371830540132005,1,4,4,9,39,0.366871,0.002632,0.000288
371830525043017,1,4,4,9,112,0.367945,0.007505,0.00024
371830540131032,2,1,4,7,4,1.022925,0.076914,0.000488
371830540044000,2,4,4,10,262,0.96696,0.007237,0.000104
371830537111027,3,5,5,13,15,1.932691,0,0
371830528033070,3,5,5,13,6,1.989821,0,0
371830537121021,2,4,5,11,26,0.834678,0.004246,8.2e-05
371830537093010,4,5,5,14,592,2.834321,0,0
371830537071019,2,5,4,11,46,0.744605,0.001169,0.000134
371830545002026,2,5,5,12,420,1.439678,0,0
371830523013009,2,1,5,8,23,0.645652,0.033889,7.2e-05
371830515012023,1,4,4,9,47,0.279999,0.002668,0.000341
371830507003004,1,4,2,7,4,0.250361,0.005188,0.001334
371830526022004,2,4,4,10,55,0.639819,0.002575,0.000102
371830545004009,2,4,4,10,44,1.264134,0.00545,0.000141
371830528064050,2,4,4,10,36,1.156959,0.010303,0.000189
371830505002021,1,4,3,8,167,0.270808,0.005567,0.000811
371830541052004,2,5,5,12,6,1.313992,0,0
371830541043040,2,1,4,7,112,0.890687,0.03317,0.0002
371830516001022,2,4,3,9,21,0.810119,0.004843,0.000536
371830541103011,5,5,5,15,16,3.758752,0,0
371830523022012,2,5,5,12,43,1.365532,0,0
371830542081088,3,5,5,13,463,2.323772,0,0
371830515022017,1,4,4,9,37,0.280609,0.004393,0.000463
371830541063037,2,3,4,9,29,0.655541,0.016556,0.000185
371830527011010,1,4,4,9,113,0.464896,0.002575,0.000102
371830520022004,1,4,3,8,150,0.334991,0.001939,0.000791
371830507001019,1,2,1,4,35,0.037412,0.026698,0.001884
371830541044014,3,5,5,13,8,1.614086,0,0
371830540134039,3,5,5,13,46,1.987648,0,0
371830509002004,1,2,1,4,21,0.106652,0.026774,0.001714
371830528072007,2,4,4,10,90,0.87355,0.010303,0.000189
371830525072020,2,4,4,10,67,1.271933,0.002435,0.000119
371830541101005,4,5,5,14,33,3.147497,0,0
371830519002011,1,4,3,8,53,0.605379,0.00611,0.000614
371830540151032,2,4,4,10,17,0.872591,0.003023,0.000139
371830527043006,1,4,5,10,26,0.517926,0.002298,8.6e-05
371830525051031,2,3,4,9,73,1.108946,0.015238,0.00041
371830525031017,2,4,5,11,13,1.215079,0.004523,9.4e-05
371830542071072,3,5,5,13,47,2.227033,0,0
371830521013010,2,4,4,10,54,0.996938,0.010955,0.000347
371830545004015,2,3,1,6,16,0.754033,0.013592,0.002229
371830518001028,1,4,4,9,36,0.133309,0.003177,0.000397
371830527063017,3,5,5,13,69,2.035083,0,0
371830537251022,2,3,4,9,122,0.681246,0.015181,0.000348
371830507001016,1,4,1,6,61,0.247186,0.007894,0.001742
371830540132055,2,4,4,10,81,1.181031,0.002632,0.000288
371830525043015,1,4,4,9,10,0.286098,0.007597,0.000446
371830512003027,1,4,3,8,35,0.162937,0.006943,0.000657
371830528071008,2,5,5,12,551,1.395473,0,0
371830527043008,1,4,5,10,53,0.34787,0.002298,8.6e-05
371830537071010,2,5,4,11,13,1.081949,0,0.00013
371830537161003,1,3,4,8,99,0.471941,0.014256,0.000338
371830507001009,1,4,1,6,107,0.159916,0.006573,0.00174
371830541043041,2,1,4,7,105,0.944944,0.03317,0.0002
371830527061002,2,5,5,12,106,1.342463,0,0
371830524043006,2,1,4,7,123,0.69438,0.035627,0.000309
371830509002014,1,2,1,4,141,0.044214,0.022295,0.001423
371830541111017,4,5,5,14,279,2.946918,0,0
371830525032000,2,4,5,11,69,1.239834,0.004523,9.4e-05
371830537142028,2,3,4,9,8,0.966627,0.01352,0.000195
371830537171035,5,5,5,15,3,3.495071,0,0
371830540131040,1,1,4,6,48,0.542374,0.076914,0.000488
371830537191012,5,5,5,15,79,4.165084,0,0
371830524042002,2,1,4,7,922,0.775518,0.035084,0.000204
371830514001016,1,4,3,8,33,0.294569,0.006656,0.000573
371830541041005,3,5,5,13,79,1.71307,0,0
371830540133008,3,5,5,13,3,1.539942,0,0
371830528062019,2,5,5,12,129,1.364662,0,0
371830537252018,1,3,4,8,15,0.121604,0.012746,0.000229
371830518003008,1,4,4,9,25,0.52036,0.004758,0.000362
371830528063003,2,3,4,9,191,1.056893,0.016556,0.000185
371830537241046,3,5,5,13,47,1.874969,0,0
371830537092012,5,5,5,15,10,3.967469,0,0
371830541102011,5,5,5,15,112,3.61673,0,0
371830528061031,2,5,5,12,174,1.477982,0,0
371830545003002,2,5,5,12,32,1.427568,0,0
371830527051007,1,4,4,9,61,0.40794,0.004763,0.000215
371830507003030,1,4,2,7,19,0.267333,0.008484,0.001375
371830540181025,2,5,5,12,25,1.294291,0,0
371830540141017,1,4,4,9,49,0.451989,0.001332,0.00017
371830537191006,5,5,5,15,476,4.390797,0,0
371830523023022,2,5,5,12,59,1.406062,0,0
371830540111008,2,2,3,7,165,1.247147,0.025679,0.000856
371830537071011,2,5,4,11,22,0.972783,0,0.00013
371830501001116,1,2,1,4,27,0.091882,0.026698,0.001884
371830540121007,2,5,5,12,37,1.518293,0,0
371830505002001,1,4,3,8,409,0.329139,0.006659,0.000787
371830527043001,2,4,5,11,46,0.886637,0.002298,8.6e-05
371830527043021,2,4,5,11,115,0.656289,0.002298,8.6e-05
371830510002024,1,2,2,5,53,0.166062,0.025035,0.001346
371830541061035,3,5,5,13,289,1.555896,0,0
371830537241081,3,5,5,13,105,1.59198,0,0
371830506002008,1,4,1,6,56,0.139759,0.009085,0.001526
371830540163013,2,5,5,12,166,1.378591,0,0
371830518003007,2,4,4,10,22,0.684587,0.004758,0.000362
371830527051014,1,4,4,9,12,0.264685,0.002464,0.000129
371830537073005,1,3,3,7,54,0.560517,0.01546,0.0006
371830528064020,2,4,4,10,33,0.670954,0.010303,0.000189
371830540082005,2,4,4,10,361,0.846932,0.003023,0.000139
371830545004005,2,4,4,10,49,1.035739,0.00545,0.000141
371830537152008,2,3,4,9,1,1.030405,0.01352,0.000195
371830540141071,3,5,5,13,6,1.990553,0,0
371830528064016,2,4,4,10,139,1.266816,0.010303,0.000189
371830518002018,1,4,4,9,46,0.3281,0.006237,0.000524
371830520021016,2,4,4,10,80,0.646712,0.006846,0.000189
371830524041001,1,1,4,6,35,0.344988,0.036867,0.000452
371830541043007,3,5,5,13,180,1.567904,0,0
371830525032014,2,4,5,11,62,0.941844,0.004523,9.4e-05
371830503002019,1,2,2,5,18,0.434757,0.022184,0.001057
371830541044021,2,4,4,10,42,0.915627,0.011337,0.000103
371830519003016,1,4,3,8,53,0.375926,0.00604,0.000543
371830518001013,1,4,4,9,91,0.271529,0.004919,0.000462
371830527071009,2,4,4,10,94,0.900873,0.011337,0.000103
371830501001045,1,4,1,6,32,0.306244,0.00561,0.001793
371830540181015,2,4,5,11,8,0.841744,0.002298,8.6e-05
371830537093037,4,5,5,14,41,2.53389,0,0
371830541052011,3,5,5,13,117,1.87218,0,0
371830541043048,3,5,5,13,12,1.978061,0,0
371830521021032,2,4,4,10,238,0.814379,0.001325,0.00015
371830537072010,1,3,4,8,87,0.468748,0.015425,0.000472
371830540112010,3,5,5,13,515,1.579125,0,0
371830537191005,5,5,5,15,56,3.933765,0,0
371830537232009,2,5,4,11,2,1.135652,3.5e-05,0.000128
371830511011001,2,4,4,10,2103,0.764432,0.004408,0.000427
371830509002018,1,2,1,4,20,0.102308,0.026713,0.001468
371830540141086,3,5,5,13,38,1.701213,0,0
371830515021002,1,4,4,9,20,0.594481,0.005239,0.000396
371830537113019,2,4,4,10,16,0.719599,0.002435,0.000119
371830536101080,3,5,5,13,83,2.009349,0,0
371830510002025,1,2,2,5,49,0.129963,0.025013,0.001274
371830526031014,1,3,3,7,94,0.36528,0.012124,0.000955
371830515022011,1,4,4,9,24,0.410529,0.002668,0.000341
371830521011015,2,4,4,10,84,1.264503,0.002514,0.000107
371830528072079,3,5,5,13,40,1.600286,0,0
371830541052020,2,5,5,12,55,1.408072,0,0
371830537162007,2,3,4,9,107,0.828669,0.014256,0.000338
371830528061027,2,5,5,12,7,1.439815,0,0
371830509001020,1,2,1,4,24,0.010447,0.027331,0.00205
371830503001009,1,4,3,8,68,0.061328,0.006861,0.000633
371830523023037,2,4,4,10,128,1.091708,0.00545,0.000141
371830506002012,1,4,2,7,10,0.153387,0.007091,0.001245
371830518001024,1,4,4,9,16,0.557087,0.004919,0.000462
371830515011039,2,4,3,9,83,0.733466,0.00533,0.000602
371830512002015,1,2,3,6,62,0.361457,0.021909,0.000876
371830540151010,1,4,4,9,46,0.150608,0.003023,0.000139
371830524072016,1,1,4,6,18,0.453841,0.036848,0.0004
371830537241026,3,5,5,13,23,1.831474,0,0
371830530082015,3,5,5,13,2,2.125047,0,0
371830527072027,2,4,4,10,50,1.26488,0.011337,0.000103
371830526023008,2,4,4,10,39,0.862714,0.002575,0.000102
371830545003011,3,5,5,13,50,1.693961,0,0
371830541102002,5,5,5,15,67,3.574686,0,0
371830537091014,3,5,5,13,340,1.674839,0,0
371830541051014,3,5,5,13,40,1.971453,0,0
371830537241052,3,5,5,13,325,1.76324,0,0
371830542081127,2,4,4,10,84,1.123869,0.002632,0.000288
371830540123000,2,4,4,10,38,0.889936,0.007237,0.000104
371830527071007,2,4,5,11,27,0.951654,0.002298,8.6e-05
371830518002025,1,4,4,9,84,0.098947,0.006237,0.000524
371830527072024,2,4,4,10,68,0.745517,0.011337,0.000103
371830516004009,1,4,3,8,28,0.316242,0.005007,0.000651
371830515012022,2,4,3,9,31,0.832729,0.00533,0.000602
371830520024001,2,4,2,8,26,0.905938,0.00289,0.00103
371830524072018,1,4,4,9,184,0.463383,0.001783,0.000248
371830540134024,3,5,5,13,85,1.774043,0,0
371830542091065,4,5,5,14,206,3.062526,0,0
371830519003003,1,4,4,9,27,0.449264,0.005034,0.000464
371830524071017,1,4,4,9,17,0.614385,0.001783,0.000248
371830514001002,1,4,4,9,41,0.261625,0.003816,0.00053
371830541041022,3,5,5,13,3,1.849525,0,0
371830541061006,3,5,5,13,176,2.023638,0,0
371830501001074,1,2,1,4,2,0.134353,0.026585,0.001432
371830536101049,3,5,5,13,85,1.688375,0,0
371830501001078,1,2,2,5,220,0.065005,0.02662,0.001349
371830515022003,1,4,4,9,125,0.133942,0.002668,0.000341
371830528033049,3,5,5,13,61,1.60731,0,0
371830509003010,1,2,1,4,55,0.01983,0.026737,0.001546
371830528063009,3,5,5,13,235,1.549298,0,0
371830526021008,1,4,4,9,26,0.63027,0.005553,0.000163
371830540111003,2,5,5,12,48,1.300535,0,0
371830540141055,3,5,5,13,110,1.648842,0,0
371830524011083,2,5,5,12,18,1.488873,0,0
371830537181012,5,5,5,15,46,4.014631,0,0
371830541102051,5,5,5,15,54,3.784403,0,0
371830537142013,1,3,3,7,45,0.619117,0.013421,0.000543
371830511012009,1,4,4,9,67,0.221055,0.002044,0.000235
371830523021008,2,3,4,9,279,0.836818,0.019121,0.000148
371830525051024,2,4,4,10,6,0.781209,0.007136,0.00048
371830540111006,2,5,5,12,98,1.422779,0,0
371830540181020,2,4,4,10,244,0.744114,0.007237,0.000104
371830536102032,1,4,4,9,21,0.243822,0.001964,0.000197
371830528064004,3,5,5,13,71,1.946006,0,0
371830514001011,1,4,4,9,40,0.433084,0.003789,0.000471
371830541052031,3,5,5,13,36,1.798723,0,0
371830537161004,1,3,4,8,119,0.113175,0.014256,0.000338
371830537261015,2,4,4,10,93,0.931959,0.002435,0.000119
371830523023038,2,5,5,12,5,1.468337,0,0
371830540011002,1,4,4,9,69,0.45861,0.005553,0.000163
371830536101017,2,5,5,12,6,1.442956,0,0
371830527073013,2,4,4,10,334,0.65009,0.011337,0.000103
371830524043000,1,1,4,6,34,0.12589,0.036867,0.000452
371830541042011,1,1,4,6,26,0.231408,0.03317,0.0002
371830517001014,1,4,4,9,51,0.10851,0.004919,0.000462
371830526012015,2,4,4,10,62,0.73315,0.008373,0.000528
371830540131021,3,5,5,13,661,1.550553,0,0
371830537071030,2,5,4,11,29,0.761723,0.001169,0.000134
371830537092008,2,5,5,12,28,1.393161,0,0
371830524041004,1,4,4,9,38,0.275237,0.002978,0.00038
371830541041039,2,1,4,7,98,0.772475,0.03317,0.0002
371830510001009,1,2,3,6,8,0.203686,0.023205,0.000709
371830537071009,2,5,4,11,62,1.044484,0.001169,0.000264
371830528072032,3,5,5,13,3,2.213443,0,0
371830508001013,1,4,2,7,81,0.077675,0.009836,0.001346
371830537072011,1,3,4,8,87,0.478467,0.015425,0.000472
371830501001030,1,4,1,6,2,0.525351,0.006517,0.001461
371830537093056,4,5,5,14,9,2.728578,0,0
371830537252032,3,5,5,13,6,1.669617,0,0
371830525043030,1,4,4,9,160,0.185062,0.007505,0.00024
371830541051004,3,5,5,13,161,2.191565,0,0
371830505003021,1,4,4,9,19,0.117855,0.004567,0.000165
371830541044015,2,4,4,10,251,1.221009,0.011337,0.000103
371830501001025,1,4,1,6,2,0.347946,0.006725,0.001797
371830528071006,2,5,5,12,79,1.406887,0,0
371830541041014,3,5,5,13,40,1.835115,0,0
371830527052006,1,4,4,9,135,0.423355,0.004763,0.000215
371830537093030,4,5,5,14,83,2.980457,0,0
371830540013002,1,4,4,9,292,0.589692,0.009896,0.000173
371830540131009,2,4,4,10,97,1.042215,0.002632,0.000288
371830517003013,2,4,4,10,83,0.931036,0.004712,0.00033
371830540143029,2,5,5,12,281,1.470801,0,0
371830541061008,3,5,5,13,22,1.846112,0,0
371830541041035,2,5,5,12,239,1.376041,0,0
371830525043022,2,4,4,10,31,0.818927,0.007505,0.00024
371830541044018,2,4,4,10,115,1.110424,0.011337,0.000103
371830507001000,1,4,1,6,94,0.346121,0.005535,0.001653
371830540134030,2,4,4,10,1,1.03658,0.001332,0.00017
371830517001005,1,4,3,8,28,0.086779,0.009064,0.000828
371830521014018,1,3,3,7,35,0.406108,0.012267,0.000588
371830507003026,1,4,1,6,13,0.112002,0.004519,0.001431
371830537251029,1,3,4,8,15,0.364194,0.012746,0.000229
371830526021016,2,4,4,10,82,0.842214,0.005234,0.000171
371830520012021,2,4,4,10,96,0.856183,0.006846,0.000189
371830536101025,3,5,5,13,79,1.817154,0,0
371830541042004,1,1,4,6,106,0.333064,0.03317,0.0002
371830523011013,1,1,5,7,33,0.49062,0.033889,7.2e-05
371830537232018,2,5,4,11,5,1.143455,0,0.00013
371830523013030,2,5,5,12,36,1.398406,0,0
371830524011043,4,5,5,14,1,2.673273,0,0
371830541101010,5,5,5,15,217,3.390022,0,0
371830516001013,2,4,3,9,50,0.875801,0.005881,0.000607
371830537221001,2,4,4,10,49,1.099479,0.010065,0.000331
371830542071084,3,5,5,13,10,2.322146,0,0
371830537171008,4,5,5,14,303,2.524275,0,0
371830503001022,1,4,2,7,3,0.17657,0.007312,0.001081
371830541041025,2,1,4,7,5,0.839921,0.03317,0.0002
371830519003015,1,4,4,9,36,0.244093,0.005034,0.000464
371830525032024,1,4,5,10,41,0.457192,0.004523,9.4e-05
371830521021040,2,4,4,10,364,1.258601,0.006846,0.000189
371830537221000,2,4,4,10,388,1.054392,0.010065,0.000331
371830528033013,3,5,5,13,30,1.542384,0,0
371830514005001,1,4,3,8,42,0.285279,0.005107,0.000533
371830524082006,1,4,4,9,38,0.329413,0.002587,0.000339
371830530081013,2,5,5,12,30,1.359028,0,0
371830528064010,3,5,5,13,44,1.611062,0,0
371830526023009,2,4,3,9,5,1.127281,0.010948,0.00063
371830541052029,3,5,5,13,124,1.814295,0,0
371830545002083,2,3,1,6,97,0.840049,0.014509,0.002533
371830541053004,3,5,5,13,14,2.037968,0,0
371830537073012,2,4,4,10,38,0.690586,0.005588,0.000292
371830518003002,1,4,4,9,159,0.054415,0.004758,0.000362
371830510002017,1,2,3,6,64,0.265517,0.022292,0.000701
371830537091007,3,5,5,13,98,1.825502,0,0
371830540121009,3,5,5,13,39,1.61988,0,0
371830540012010,2,4,4,10,161,1.076425,0.005234,0.000171
371830526011030,1,4,4,9,75,0.202472,0.004062,0.000127
371830540141000,3,5,5,13,5,2.156569,0,0
371830537111031,2,4,5,11,16,0.635676,0.004246,8.2e-05
371830537251012,2,3,4,9,35,0.77921,0.012746,0.000229
371830527062000,3,5,5,13,42,1.728554,0,0
371830506002025,1,4,3,8,8,0.210867,0.005775,0.000901
371830525042006,2,4,4,10,39,1.057113,0.007505,0.00024
371830537121019,1,4,5,10,38,0.17471,0.004246,8.2e-05
371830540163003,2,1,4,7,89,0.760879,0.059635,0.000247
371830537192002,5,5,5,15,102,4.686955,0,0
371830516005020,1,4,4,9,58,0.541458,0.004864,0.000518
371830542091066,4,5,5,14,499,2.963726,0,0
371830501001073,1,2,1,4,2,0.060584,0.026667,0.001495
371830527051004,2,4,4,10,149,0.672313,0.004763,0.000215
371830542071098,3,5,5,13,24,2.129375,0,0
371830501001105,1,2,1,4,20,0.163752,0.026628,0.001813
371830537211028,4,5,5,14,27,2.615205,0,0
371830540163012,2,5,5,12,64,1.371145,0,0
371830518003018,1,4,4,9,216,0.47719,0.004919,0.000462
371830516004015,1,4,3,8,63,0.271599,0.005007,0.000651
371830512003013,1,4,3,8,56,0.08569,0.00815,0.000695
371830537223007,2,4,4,10,136,0.889218,0.010065,0.000201
371830520022000,1,4,3,8,167,0.606921,0.001467,0.000655
371830541051010,3,5,5,13,39,2.252032,0,0
371830542091040,5,5,5,15,447,3.569337,0,0
371830524011050,4,5,5,14,44,2.441683,0,0
371830525041007,3,5,5,13,87,1.538657,0,0
371830537072008,2,5,4,11,117,0.701631,0.001204,0.000392
371830523011014,1,1,5,7,2,0.5094,0.033889,7.2e-05
371830541061049,3,5,5,13,25,1.805961,0,0
371830536101064,2,4,4,10,478,0.677086,0.001964,0.000197
371830507003006,1,4,3,8,351,0.209881,0.003462,0.000841
371830501001081,1,2,1,4,53,0.00097,0.023888,0.001537
371830514005014,1,4,3,8,53,0.297493,0.0067,0.000533
371830542102033,5,5,5,15,4,3.715755,0,0
371830524012000,2,4,4,10,957,0.847802,0.002299,0.000264
371830540133000,3,5,5,13,965,1.975267,0,0
371830526032014,1,4,3,8,323,0.316925,0.008856,0.000655
371830523013028,2,5,5,12,42,1.388762,0,0
371830541103008,5,5,5,15,144,3.650707,0,0
371830528064013,3,5,5,13,49,2.178715,0,0
371830537211046,4,5,5,14,15,2.473995,0,0
371830516003014,2,4,4,10,199,0.651477,0.003399,0.000415
371830541054026,2,4,4,10,1,1.106812,0.011337,0.000103
371830537071007,2,5,4,11,1,0.945103,0,0.00013
371830537111017,3,5,5,13,116,1.930311,0,0
371830501001034,1,2,2,5,2,0.460776,0.022541,0.00125
371830537222011,2,5,5,12,328,1.398024,0,0
371830540162029,2,1,4,7,44,1.192994,0.059635,0.000247
371830537151007,1,3,4,8,54,0.413481,0.012254,0.000211
371830527072015,1,4,4,9,37,0.452333,0.011337,0.000103
371830537093040,4,5,5,14,7,3.244264,0,0
371830540143017,2,5,5,12,79,1.476673,0,0
371830540042000,2,4,4,10,153,0.647467,0.007237,0.000104
371830528064003,3,5,5,13,61,1.909758,0,0
371830537092004,3,5,5,13,828,1.605403,0,0
371830519001008,1,4,4,9,105,0.610803,0.005034,0.000464
371830537151003,1,3,3,7,215,0.089252,0.01546,0.0006
371830517002014,1,4,4,9,17,0.613907,0.004919,0.000462
371830537241000,3,5,5,13,175,1.68467,0,0
371830509003006,1,2,1,4,56,0.229444,0.026833,0.001782
371830523021012,2,5,5,12,17,0.867894,1.9e-05,5.2e-05
371830528063017,3,5,5,13,3,1.814556,0,0
371830524071027,1,1,4,6,140,0.552977,0.036848,0.0004
371830541102040,4,5,5,14,8,2.828654,0,0
371830506002022,1,4,2,7,15,0.129619,0.006781,0.00098
371830527052009,1,4,4,9,125,0.604557,0.004763,0.000215
371830508001016,1,4,1,6,32,0.082072,0.010332,0.001538
370630019002069,5,5,5,15,52,4.600135,0,0
371830525043004,2,4,5,11,352,1.194866,0.004523,9.4e-05
371830512001006,1,4,3,8,65,0.161833,0.006861,0.000633
371830520022010,1,4,3,8,38,0.542949,0.001467,0.000655
371830509003007,1,2,1,4,82,0.148954,0.026833,0.001782
371830510001020,1,3,3,7,19,0.375415,0.021651,0.000886
371830540122005,1,4,4,9,100,0.439402,0.007237,0.000104
371830514004004,2,4,3,9,47,0.732094,0.00737,0.000649
371830525061002,1,3,3,7,11,0.261439,0.013421,0.000543
371830541052006,3,5,5,13,645,1.88916,0,0
371830540151017,2,4,4,10,104,1.234604,0.003023,0.000139
371830536101062,2,4,4,10,50,1.283528,0.001964,0.000197
371830541044016,2,5,5,12,67,1.414161,0,0
371830528064049,3,5,5,13,66,1.926735,0,0
371830509003000,1,2,1,4,39,0.014948,0.027226,0.001797
371830525041003,2,5,5,12,117,1.313044,0,0
371830526021006,2,4,4,10,62,0.719638,0.00583,0.00033
371830541102021,5,5,5,15,30,3.668612,0,0
371830520021015,1,4,4,9,39,0.595587,0.006846,0.000189
371830540182011,2,5,5,12,50,1.488943,0,0
371830537261002,2,4,4,10,87,0.962818,0.002435,0.000119
371830524043005,1,1,4,6,84,0.601471,0.036848,0.0004
371830521011004,1,4,4,9,35,0.375507,0.009606,0.000363
371830545004016,1,4,4,9,8,0.609268,0.00545,0.000141
371830526022002,1,4,4,9,61,0.344996,0.002575,0.000102
371830542081125,2,4,4,10,86,0.923429,0.002632,0.000288
371830540142007,1,4,4,9,18,0.604248,0.001332,0.00017
371830541131016,5,5,5,15,12,4.630356,0,0
371830506002002,1,4,3,8,26,0.024943,0.00662,0.000932
371830536101046,3,5,5,13,50,1.896293,0,0
371830516002018,1,4,4,9,39,0.450471,0.002962,0.000222
371830523022010,2,4,4,10,821,1.226477,0.00545,0.000141
371830536101019,2,5,5,12,46,1.353616,0,0
371830518002022,1,4,4,9,13,0.137897,0.004919,0.000462
371830524062031,2,5,5,12,11,1.511763,0,0
371830527052020,1,4,4,9,61,0.552762,0.002464,0.000129
371830537162009,1,3,4,8,33,0.510968,0.014256,0.000338
371830540072013,2,5,4,11,380,1.057927,3.5e-05,0.000128
371830516002022,1,4,4,9,29,0.209795,0.00418,0.000402
371830528072041,4,5,5,14,3,2.818672,0,0
371830537072014,1,3,4,8,90,0.340722,0.015425,0.000472
371830537112013,1,3,4,8,144,0.60721,0.012746,0.000229
371830537163001,2,3,4,9,941,1.03265,0.016638,0.00024
371830528033009,3,5,5,13,126,1.895771,0,0
371830537122011,2,4,5,11,174,0.91412,0.004246,8.2e-05
371830540162028,2,1,4,7,233,1.204484,0.059635,0.000247
371830537241067,3,5,5,13,187,1.693068,0,0
371830541101012,5,5,5,15,214,3.62846,0,0
371830506002038,1,4,2,7,1,0.16831,0.005188,0.001334
371830537252013,2,4,4,10,164,1.019005,0.0085,0.000147
371830512002018,1,3,3,7,9,0.397543,0.021718,0.000727
371830525072021,2,5,5,12,29,1.443064,0,0
371830510001004,2,3,3,8,148,0.642876,0.021593,0.000877
371830528063011,3,5,5,13,890,2.135159,0,0
371830518001026,2,4,3,9,39,0.700574,0.009823,0.000734
371830526031012,1,4,3,8,131,0.601573,0.009064,0.000828
371830512001009,1,4,3,8,60,0.379238,0.0067,0.000533
371830540141004,3,5,5,13,478,1.838956,0,0
371830524061006,2,1,4,7,74,1.050215,0.034432,0.000176
371830521011007,2,4,4,10,106,0.901378,0.009606,0.000363
371830540134033,3,5,5,13,57,1.96183,0,0
371830501001113,1,2,1,4,2,0.247035,0.022778,0.001548
371830525041008,2,5,5,12,75,1.357838,0,0
371830541132011,4,5,5,14,18,3.271908,0,0
371830540082014,2,4,4,10,69,1.010365,0.005321,0.000225
371830541103010,5,5,5,15,114,3.738779,0,0
371830540133007,3,5,5,13,105,1.72664,0,0
371830541061016,3,5,5,13,12,2.22316,0,0
371830528033039,2,4,4,10,2,0.684285,0.002993,0.000222
371830541103039,3,5,5,13,11,2.428141,0,0
371830515011025,1,4,4,9,31,0.236156,0.007136,0.00048
371830528061032,2,4,4,10,32,0.986343,0.010303,0.000189
371830542071108,2,5,5,12,130,1.39386,0,0
371830523021050,1,2,3,6,136,0.319047,0.022973,0.000771
371830519001039,1,4,3,8,20,0.384893,0.005675,0.000781
371830528062004,2,5,5,12,6,1.451936,0,0
371830540011000,1,4,4,9,330,0.400769,0.005553,0.000163
371830540134013,3,5,5,13,217,2.132754,0,0
371830525042005,2,4,4,10,55,0.940486,0.007505,0.00024
371830526011005,2,4,4,10,30,0.889275,0.004062,0.000127
371830514002010,1,4,3,8,85,0.381705,0.006832,0.000633
371830527072026,2,4,4,10,102,1.071919,0.011337,0.000103
371830525071012,2,5,5,12,33,1.333614,0,0
371830537181010,5,5,5,15,144,4.465855,0,0
371830542081126,2,4,4,10,64,1.219913,0.002632,0.000288
371830526023003,1,4,4,9,81,0.583574,0.002575,0.000102
371830540141066,2,4,4,10,1,0.85504,0.001332,0.00017
371830540151007,2,4,4,10,11,1.113627,0.003023,0.000139
371830504002008,1,4,2,7,4,0.073928,0.007638,0.001225
371830527011020,1,4,4,9,848,0.074708,0.002575,0.000102
371830515022019,1,4,4,9,100,0.211343,0.00418,0.000402
371830516001003,2,4,4,10,25,1.05635,0.00255,0.000131
371830503002011,1,2,2,5,19,0.550568,0.022101,0.001075
371830526021018,2,4,4,10,36,0.804089,0.005234,0.000171
371830528072068,1,4,4,9,63,0.475657,0.010303,0.000189
371830517001020,1,4,4,9,69,0.196457,0.004919,0.000462
371830540111000,2,5,5,12,44,1.507377,0,0
371830521014008,1,3,3,7,11,0.550717,0.014794,0.000604
371830541043029,2,5,5,12,179,1.436465,0,0
371830540141012,2,5,5,12,50,1.530094,0,0
371830516001012,2,4,4,10,45,0.789639,0.005226,0.000472
371830530081015,2,1,5,8,131,1.140865,0.033889,7.2e-05
371830506001006,1,4,2,7,45,0.195022,0.007294,0.000994
371830527072004,2,3,4,9,76,1.069688,0.0161,0.000318
371830501001104,1,2,1,4,68,0.148755,0.023422,0.001784
371830526022000,1,4,4,9,35,0.270126,0.002575,0.000102
371830541063003,2,5,5,12,144,1.333889,0,0
371830541102042,3,5,5,13,226,2.197133,0,0
371830510001003,1,3,3,7,46,0.518592,0.021729,0.00094
371830511012006,1,5,4,10,52,0.623467,0.000849,0.000102
371830516003005,2,4,4,10,59,0.721331,0.004183,0.000371
371830526012005,1,4,4,9,39,0.377308,0.004062,0.000127
371830519001036,1,4,3,8,23,0.240425,0.005806,0.00079
371830520023008,2,4,4,10,72,0.700935,0.006846,0.000189
371830537231001,2,4,4,10,76,0.961387,0.010065,0.000331
371830537142012,2,4,4,10,13,0.702942,0.002435,0.000119
371830540121015,2,4,4,10,8,0.74225,0.007237,0.000104
371830512003012,1,4,3,8,45,0.096087,0.00815,0.000695
371830537224006,1,4,4,9,24,0.266193,0.010065,0.000331
371830525032006,2,4,5,11,63,1.217575,0.004523,9.4e-05
371830516002014,1,4,4,9,34,0.348733,0.002962,0.000222
371830540181007,2,4,4,10,43,0.64751,0.007237,0.000104
371830540131011,3,5,5,13,515,1.716169,0,0
371830506002001,1,4,3,8,21,0.15857,0.006681,0.00086
371830537093034,4,5,5,14,23,2.453836,0,0
371830540131027,2,5,5,12,78,1.438171,0,0
371830540082000,2,4,4,10,779,0.670263,0.003023,0.000139
371830538082023,2,5,5,12,65,1.506387,0,0
371830527043000,2,4,5,11,3,0.953501,0.002298,8.6e-05
371830508003003,1,4,2,7,127,0.092072,0.00849,0.001327
371830530081034,2,1,5,8,53,0.865636,0.033889,7.2e-05
371830501001089,1,2,1,4,8,0.077322,0.023101,0.00169
371830545004002,2,4,4,10,78,0.66948,0.00545,0.000141
371830517002009,2,4,3,9,25,0.722595,0.00923,0.000863
371830537132010,2,4,5,11,95,0.760936,0.004246,8.2e-05
371830517003006,2,4,4,10,76,1.072238,0.004153,0.000334
371830504001032,1,4,3,8,58,0.334263,0.005567,0.000811
371830521011005,1,4,4,9,48,0.405505,0.009606,0.000363
371830510002003,1,2,2,5,56,0.29232,0.025487,0.000996
371830537093053,3,5,5,13,71,2.337904,0,0
371830537222012,2,5,5,12,76,1.3855,0,0
371830541042014,1,1,4,6,162,0.316566,0.03317,0.0002
371830527073018,2,4,4,10,331,1.064352,0.011337,0.000103
371830537093000,3,5,5,13,44,2.360521,0,0
371830515012030,2,5,5,12,51,0.819138,0.001038,7e-05
371830528033035,2,5,5,12,216,1.36886,0,0
371830508001002,1,4,2,7,82,0.161611,0.007472,0.001377
371830537252008,2,4,4,10,126,1.015705,0.0085,0.000147
371830541062032,2,4,4,10,133,1.050739,0.006846,0.000189
371830540011007,1,4,4,9,67,0.585607,0.005553,0.000163
371830527063009,3,5,5,13,3,2.007018,0,0
371830540181027,2,4,5,11,4,0.734812,0.002298,8.6e-05
371830521014017,1,3,3,7,32,0.365408,0.013541,0.00076
371830541101007,4,5,5,14,80,2.909417,0,0
371830527073009,2,4,4,10,42,1.186182,0.011337,0.000103
371830538084021,1,2,3,6,16,0.604145,0.025679,0.000856
371830537122012,2,4,5,11,202,0.996104,0.004246,8.2e-05
371830527072009,2,4,4,10,7,0.879799,0.011337,0.000103
371830505001004,1,4,3,8,18,0.322749,0.006205,0.000935
371830540171008,2,5,5,12,51,1.404934,0,0
371830541062035,2,4,4,10,238,0.640189,0.006846,0.000189
371830537161000,2,3,4,9,369,0.667425,0.014256,0.000338
371830508002002,1,2,2,5,107,0.092427,0.026092,0.001338
371830506002018,1,4,2,7,28,0.141529,0.005175,0.001275
371830520023003,1,4,4,9,58,0.284595,0.006846,0.000189
371830511023004,1,2,3,6,869,0.395334,0.023792,0.00088
371830520021017,1,4,4,9,39,0.387564,0.006846,0.000189
371830540163001,2,1,4,7,502,1.135174,0.059635,0.000247
371830540131025,3,5,5,13,178,1.544637,0,0
371830524063002,4,5,5,14,20,2.583409,0,0
371830528064052,2,5,5,12,199,1.504856,0,0
371830516001005,2,4,3,9,91,0.873914,0.009383,0.000795
371830537131002,1,4,5,10,93,0.549012,0.004246,8.2e-05
371830542071078,4,5,5,14,662,2.689811,0,0
371830506002028,1,4,2,7,5,0.227822,0.005163,0.001216
371830524082011,1,4,4,9,131,0.369542,0.001737,0.000237
371830523012003,1,1,5,7,383,0.378057,0.033889,7.2e-05
371830524071013,2,4,4,10,87,1.073509,0.00209,0.000246
371830540071011,2,5,4,11,466,1.059631,3.5e-05,0.000128
371830526031006,1,4,3,8,202,0.593031,0.009064,0.000828
371830525051005,2,5,5,12,101,1.382123,0,0
371830541043039,3,5,5,13,49,1.637404,0,0
371830514005012,1,4,3,8,27,0.145511,0.00815,0.000695
371830545003004,2,5,5,12,45,1.488075,0,0
371830528072069,2,4,4,10,18,0.643228,0.010303,0.000189
371830540151029,2,4,4,10,87,1.163959,0.003023,0.000139
371830540151040,1,4,4,9,22,0.40943,0.003023,0.000139
371830541044019,2,4,4,10,270,1.12449,0.011337,0.000103
371830524072003,1,4,4,9,29,0.499931,0.001783,0.000248
371830521014013,1,3,4,8,41,0.357335,0.012157,0.000435
371830526031002,2,4,4,10,83,0.672829,0.007723,0.000326
371830537224002,2,5,4,11,91,0.651196,0,0.00013
371830524081013,1,4,4,9,71,0.422691,0.002044,0.000235
371830515011004,1,4,4,9,5,0.439579,0.007136,0.00048
371830527041007,1,4,4,9,54,0.266135,0.004763,0.000215
371830537132015,1,4,5,10,24,0.476539,0.004246,8.2e-05
371830520022007,1,4,3,8,192,0.517889,0.001467,0.000655
371830524072005,2,4,4,10,55,0.82417,0.00124,0.000144
371830537251007,2,3,4,9,537,1.011196,0.012746,0.000229
371830540132008,2,5,5,12,34,1.43787,0,0
371830537072016,1,3,4,8,86,0.306904,0.012531,0.000508
371830540123003,2,4,4,10,88,0.972803,0.007237,0.000104
371830540162013,2,1,4,7,36,1.108733,0.059635,0.000247
371830537151006,1,3,4,8,413,0.619536,0.012254,0.000211
371830504001017,2,4,2,8,76,0.691198,0.003097,0.001095
371830516001001,2,4,3,9,397,0.995639,0.005515,0.000602
371830541063014,2,5,5,12,28,1.344279,0,0
371830528062012,3,5,5,13,25,1.757402,0,0
371830525043021,2,4,4,10,363,0.921167,0.007505,0.00024
371830537132001,1,4,5,10,327,0.327625,0.004246,8.2e-05
371830536102008,2,4,4,10,657,1.241313,0.001964,0.000197
371830528072077,2,4,4,10,287,0.704507,0.010303,0.000189
371830526011027,1,4,4,9,258,0.440302,0.004062,0.000127
371830541051031,3,5,5,13,149,1.937239,0,0
371830530081019,2,1,5,8,490,1.232009,0.033889,7.2e-05
371830525052003,3,5,5,13,1134,1.583121,0,0
371830528064001,3,5,5,13,167,1.843323,0,0
371830523021037,1,2,4,7,13,0.308884,0.022056,0.000467
371830527073005,2,4,4,10,290,1.108754,0.011337,0.000103
